ore -> ore
cardinal -> cardinal
mosh -> mosh
unawareness -> unawareness
roleplaying -> roleplaying
stoppage -> stoppage
paint -> paint
attitude -> attitude
haulage -> haulage
horror -> horror
methylene -> methylene
enlargement -> enlargement
spore -> spore
manager -> manager
disparity -> disparity
racket -> racket
medication -> medication
retreat -> retreat
dance -> dance
nonfiction -> nonfiction
fielding -> fielding
garrison -> garrison
colleague -> colleague
ant -> ant
mania -> mania
comb -> comb
textbook -> textbook
ingot -> ingot
sex -> sex
scholar -> scholar
courtesy -> courtesy
elizabeth -> elizabeth
volatility -> volatility
politician -> politician
fume -> fume
germ -> germ
risk -> risk
attraction -> attraction
demolition -> demolition
baker -> baker
example -> example
redundancy -> redundancy
intensity -> intensity
pop -> pop
mass -> mass
aerospace -> aerospace
hours -> hours
angler -> angler
competition -> competition
diesel -> diesel
excrement -> excrement
campsite -> campsite
silver -> silver
tone -> tone
vacancy -> vacancy
broadband -> broadband
microwave -> microwave
limitation -> limitation
vintage -> vintage
imaging -> imaging
differential -> differential
workplace -> workplace
compromise -> compromise
calf -> calf
banana -> banana
telephone -> telephone
physics -> physics
advocacy -> advocacy
cache -> cache
christian -> christian
saleswoman -> saleswoman
junior -> junior
workweek -> workweek
menace -> menace
contract -> contract
kidney -> kidney
pork barrel -> pork_barrel
skull -> skull
runner-up -> runner#up
knife -> knife
laura -> laura
alarmist -> alarmist
sample -> sample
exemption -> exemption
toy -> toy
ratio -> ratio
refining -> refining
swamp -> swamp
derailment -> derailment
encryption -> encryption
golf -> golf
parts -> parts
enterprise -> enterprise
switcher -> switcher
detection -> detection
separatist -> separatist
single -> single
conversation -> conversation
retiree -> retiree
monoxide -> monoxide
appendage -> appendage
interview -> interview
ranger -> ranger
charter -> charter
snyder -> snyder
deficit -> deficit
boomer -> boomer
act -> act
handler -> handler
bra -> bra
dudley -> dudley
wiggle -> wiggle
lt. -> lt.
potassium -> potassium
throat -> throat
loss -> loss
roskam -> roskam
contribution -> contribution
condominium -> condominium
lead -> lead
lottery -> lottery
buy-out -> buyout
ashley -> ashley
marble -> marble
proposal -> proposal
needle -> needle
program trading -> program#trading
court -> court
trailer -> trailer
endurance -> endurance
pension -> pension
certification -> certification
clash -> clash
lense -> lense
packaging -> packaging
arm -> arm
prosecutor -> prosecutor
manipulation -> manipulation
breaststroke -> breaststroke
circulation -> circulation
parachute -> parachute
probe -> probe
clergy -> clergy
screening -> screening
jackhammer -> jackhammer
interval -> interval
chicken -> chicken
fence -> fence
smog -> smog
ethic -> ethic
hand -> hand
fragment -> fragment
release -> release
dog -> dog
owner -> owner
preparation -> preparation
law -> law
peacock -> peacock
pitch -> pitch
rules -> rules
dispute -> dispute
championship -> championship
profits -> profits
inhalation -> inhalation
winner -> winner
forward -> forward
founder -> founder
betting -> betting
joke -> joke
baloney -> baloney
mcdonald -> mcdonald
complex -> complex
recording -> recording
tattoo -> tattoo
accord -> accord
fracture -> fracture
hardware -> hardware
theater -> theater
induction -> induction
poverty -> poverty
weight -> weight
prisoner -> prisoner
space -> space
kingpin -> kingpin
sausage -> sausage
outline -> outline
stock market -> stock#market
transition -> transition
coffee -> coffee
cash -> cash
lane -> lane
epidemic -> epidemic
mixer -> mixer
dividend -> dividend
drain -> drain
vigil -> vigil
whaler -> whaler
broadcasting -> broadcasting
border -> border
outlet -> outlet
database -> database
urchin -> urchin
derivative -> derivative
porcelain -> porcelain
conversion -> conversion
admiral -> admiral
keynote -> keynote
category -> category
pasta -> pasta
morale -> morale
sea -> sea
couch potato -> couch_potato
honeymoon -> honeymoon
no-fly -> no#fly
handover -> handover
marriage -> marriage
adult -> adult
ring -> ring
run -> run
trapeze -> trapeze
cafeteria -> cafeteria
einstein -> einstein
turbine -> turbine
response -> response
wasteland -> wasteland
stimulators -> stimulators
textile -> textile
dust -> dust
grid -> grid
pichia -> pichia
layer -> layer
startup -> startup
prostate -> prostate
tool -> tool
chorizo -> chorizo
psychoanalysis -> psychoanalysis
bank teller -> bank#teller
pariah -> pariah
minute -> minute
prevalence -> prevalence
passion -> passion
cortisone -> cortisone
sandra -> sandra
planner -> planner
casualty -> casualty
caramel -> caramel
flight -> flight
map -> map
recruit -> recruit
viability -> viability
satisfaction -> satisfaction
fall -> fall
carpenter -> carpenter
docking -> docking
drink -> drink
buzz -> buzz
wings -> wings
exile -> exile
domain -> domain
degrees -> degrees
polyurethane -> polyurethane
gym -> gym
antihistamine -> antihistamine
railway -> railway
moonbeam -> moonbeam
offseason -> offseason
craps -> craps
shrine -> shrine
bread -> bread
advantage -> advantage
transportation -> transportation
volunteer -> volunteer
hybrid -> hybrid
outburst -> outburst
experiment -> experiment
remedy -> remedy
securities -> securities
highland -> highland
magazine -> magazine
solution -> solution
doll -> doll
midmorning -> midmorning
saw -> saw
overcrowding -> overcrowding
bidding -> bidding
trace -> trace
lodge -> lodge
broker -> broker
damage -> damage
entrepreneur -> entrepreneur
cemetery -> cemetery
delinquency -> delinquency
gust -> gust
retail -> retail
astronaut -> astronaut
doug -> doug
contributor -> contributor
protest -> protest
tablespoon -> tablespoon
device -> device
ounce -> ounce
credit card -> credit_card
postseason -> postseason
growth -> growth
manatee -> manatee
regime -> regime
nick -> nick
terror -> terror
army -> army
alimony -> alimony
golfer -> golfer
unveiling -> unveiling
narcotics -> narcotics
fork -> fork
badger -> badger
firm -> firm
subscription -> subscription
workforce -> workforce
copy -> copy
stake -> stake
concept -> concept
loafer -> loafer
margin -> margin
regulations -> regulations
quake -> quake
warbler -> warbler
redeployment -> redeployment
oxide -> oxide
prostitution -> prostitution
skirt -> skirt
manifesto -> manifesto
action -> action
sell-offs -> sell#offs
gregory -> gregory
condensation -> condensation
wrecking -> wrecking
oxygen -> oxygen
troop -> troop
berry -> berry
bear -> bear
pianist -> pianist
league -> league
letter -> letter
ranking -> ranking
embargo -> embargo
hemorrhage -> hemorrhage
friction -> friction
hall -> hall
count -> count
heating -> heating
jazz -> jazz
consulting -> consulting
style -> style
cheat -> cheat
malaria -> malaria
propane -> propane
freshmen -> freshmen
writing -> writing
manslaughter -> manslaughter
installment -> installment
captain -> captain
champagne -> champagne
peel -> peel
tomato -> tomato
bureaus -> bureaus
typewriter -> typewriter
burger -> burger
metals -> metals
graft -> graft
borrowing -> borrowing
spa -> spa
description -> description
specimen -> specimen
clothe -> clothe
trait -> trait
alternative -> alternative
sheriff -> sheriff
blank -> blank
nationality -> nationality
radical -> radical
clerk -> clerk
ashcroft -> ashcroft
mission -> mission
dome -> dome
portfolio -> portfolio
mark -> mark
junkyard -> junkyard
responsibility -> responsibility
finance -> finance
holder -> holder
aristide -> aristide
fantasy -> fantasy
momentum -> momentum
default -> default
pursuit -> pursuit
launcher -> launcher
underclass -> underclass
birder -> birder
board -> board
souvenir -> souvenir
colon -> colon
panel -> panel
breeding -> breeding
expense account -> expense#account
brush -> brush
winery -> winery
raffle -> raffle
feature -> feature
journey -> journey
bargaining -> bargaining
playbook -> playbook
delegate -> delegate
college -> college
amanda -> amanda
semester -> semester
mahogany -> mahogany
entity -> entity
consolidation -> consolidation
contention -> contention
popcorn -> popcorn
trend -> trend
grassland -> grassland
goblin -> goblin
defendant -> defendant
aggressiveness -> aggressiveness
extremist -> extremist
scene -> scene
uprising -> uprising
leo -> leo
cooperative -> cooperative
pinch -> pinch
battalion -> battalion
skater -> skater
lithium -> lithium
fortune -> fortune
rack -> rack
monsoon -> monsoon
argument -> argument
ox -> ox
guitar -> guitar
dilemma -> dilemma
chassis -> chassis
agony -> agony
parking -> parking
addict -> addict
aureus -> aureus
biology -> biology
taking -> taking
draft -> draft
testimony -> testimony
preference -> preference
corduroy -> corduroy
effectiveness -> effectiveness
liner -> liner
tummy -> tummy
scientist -> scientist
damages -> damages
program -> program
cabaret -> cabaret
survey -> survey
interbank -> interbank
sourdough -> sourdough
laptop -> laptop
one -> one
counsel -> counsel
domination -> domination
market -> market
ray -> ray
ailment -> ailment
influenza -> influenza
developer -> developer
dish -> dish
days -> days
tv -> tv
shareholder -> shareholder
ranch -> ranch
puppet -> puppet
enforcer -> enforcer
surface -> surface
ballistics -> ballistics
artist -> artist
barge -> barge
satire -> satire
title -> title
celebrity -> celebrity
buffet -> buffet
gen. -> gen.
blade -> blade
whale -> whale
voting -> voting
rumor -> rumor
syndicate -> syndicate
correction -> correction
coalition -> coalition
cheese -> cheese
path -> path
raising -> raising
ambulance -> ambulance
adequacy -> adequacy
shock -> shock
employee -> employee
skating -> skating
evaluation -> evaluation
tile -> tile
motorist -> motorist
telecom -> telecom
constituent -> constituent
gossip -> gossip
flexibility -> flexibility
engineer -> engineer
bedroom -> bedroom
guzzler -> guzzler
herd -> herd
credibility -> credibility
tenant -> tenant
rhythm -> rhythm
transmission -> transmission
hewlett -> hewlett
temper -> temper
person -> person
brief -> brief
smallpox -> smallpox
fleet -> fleet
gum -> gum
milk -> milk
sphere -> sphere
policyholder -> policyholder
checkpoint -> checkpoint
environment -> environment
drum -> drum
senator -> senator
temple -> temple
rot -> rot
coal -> coal
lapel -> lapel
tank -> tank
thunder -> thunder
lung -> lung
campus -> campus
blazer -> blazer
aisle -> aisle
merchant -> merchant
pc -> pc
publisher -> publisher
scare -> scare
potato -> potato
grower -> grower
reform -> reform
infant -> infant
hitting -> hitting
robot -> robot
st. -> st.
trinket -> trinket
guide -> guide
toner -> toner
front -> front
miller -> miller
thigh -> thigh
gang -> gang
bowling -> bowling
infusion -> infusion
incidence -> incidence
fishing -> fishing
beta -> beta
fare -> fare
crew -> crew
playground -> playground
electricity -> electricity
mausoleum -> mausoleum
roll call -> roll#call
accessory -> accessory
mouthpiece -> mouthpiece
gut -> gut
prayer -> prayer
tunnel -> tunnel
eddie -> eddie
bacillus -> bacillus
raise -> raise
concrete -> concrete
managing -> managing
breast -> breast
thrift industry -> thrift#industry
filing -> filing
raymond -> raymond
sondheim -> sondheim
financier -> financier
hill -> hill
crab -> crab
rider -> rider
chop -> chop
reshuffle -> reshuffle
study -> study
debt -> debt
jug -> jug
o'donnell -> o'donnell
furnishings -> furnishings
behavior -> behavior
apartheid -> apartheid
projection -> projection
helmet -> helmet
dandelion -> dandelion
rookie -> rookie
copycat -> copycat
innocence -> innocence
nicotine -> nicotine
commander -> commander
floor -> floor
walking -> walking
stomach -> stomach
canola -> canola
bat -> bat
philosophy -> philosophy
violation -> violation
traction -> traction
inch -> inch
hazard -> hazard
cartel -> cartel
rabbit -> rabbit
tissue -> tissue
error -> error
antibiotic -> antibiotic
colony -> colony
tarmac -> tarmac
friend -> friend
deuterium -> deuterium
fumble -> fumble
dung -> dung
candle -> candle
certificate -> certificate
proposition -> proposition
earthquake -> earthquake
lesion -> lesion
percent -> percent
individual -> individual
server -> server
nominee -> nominee
observer -> observer
cart -> cart
deportation -> deportation
leadership -> leadership
congestion -> congestion
round -> round
catch -> catch
heroin -> heroin
speciality -> speciality
assassination -> assassination
proliferation -> proliferation
detective -> detective
waterfront -> waterfront
coke -> coke
herbicide -> herbicide
hamstring -> hamstring
pertussis -> pertussis
wedding -> wedding
blowout -> blowout
fly -> fly
mud -> mud
copier -> copier
bank -> bank
dinner -> dinner
career -> career
theodore -> theodore
volume -> volume
giants -> giants
hospitality -> hospitality
media -> media
wish -> wish
fabric -> fabric
snake -> snake
snack -> snack
malcolm -> malcolm
psyllium -> psyllium
bailout -> bailout
coordination -> coordination
minister -> minister
stair -> stair
section -> section
shop -> shop
salt -> salt
denim -> denim
toast -> toast
print -> print
mom -> mom
tear -> tear
proximity -> proximity
arms -> arms
killing -> killing
hip -> hip
privilege -> privilege
vet -> vet
fiberglass -> fiberglass
guarantee -> guarantee
skid -> skid
festival -> festival
interviewer -> interviewer
round-table -> roundtable
bow -> bow
chloride -> chloride
terrorism -> terrorism
rapper -> rapper
researcher -> researcher
goose -> goose
lamp -> lamp
deduction -> deduction
smuggler -> smuggler
programme -> programme
swimsuit -> swimsuit
leash -> leash
jorge -> jorge
aid -> aid
baby -> baby
missile -> missile
crack -> crack
week -> week
prevention -> prevention
consumption -> consumption
proficiency -> proficiency
sponsorship -> sponsorship
consumer -> consumer
dropout -> dropout
business -> business
mitigation -> mitigation
sleeping -> sleeping
architecture -> architecture
sports -> sports
carlos -> carlos
blackjack -> blackjack
increase -> increase
appetite -> appetite
funnel -> funnel
radar -> radar
signature -> signature
luxury -> luxury
contraction -> contraction
singer -> singer
privacy -> privacy
discount -> discount
barite -> barite
motorcade -> motorcade
truth -> truth
jumping -> jumping
threat -> threat
solo -> solo
acquisition -> acquisition
buyback -> buyback
carp -> carp
influx -> influx
brass -> brass
succession -> succession
minerals -> minerals
town -> town
cigar -> cigar
payroll -> payroll
comic -> comic
search -> search
rivalry -> rivalry
rerun -> rerun
editor -> editor
warfare -> warfare
sweeper -> sweeper
franchise -> franchise
pajama -> pajama
opinion -> opinion
workers -> workers
conciliation -> conciliation
hunger -> hunger
pace -> pace
governance -> governance
bureaucrat -> bureaucrat
photocopier -> photocopier
circumcision -> circumcision
couple -> couple
environmentalist -> environmentalist
yield -> yield
correspondent -> correspondent
time -> time
outlook -> outlook
videodisk -> videodisk
baseball -> baseball
spanish language -> spanish#language
immunity -> immunity
column -> column
extraction -> extraction
doomsday -> doomsday
waxwork -> waxwork
balance-of-payments -> balance#of#payments
pelt -> pelt
fisherman -> fisherman
mechanic -> mechanic
giver -> giver
labor -> labor
clinic -> clinic
drop -> drop
crowd -> crowd
stint -> stint
migraine -> migraine
update -> update
indebtedness -> indebtedness
revenue -> revenue
methadone -> methadone
rocket -> rocket
cube -> cube
billionaire -> billionaire
midtown -> midtown
distillation -> distillation
rationalisation -> rationalisation
lobby -> lobby
implication -> implication
acid -> acid
associate -> associate
cooking -> cooking
petulance -> petulance
writer -> writer
carbon -> carbon
wetland -> wetland
shaft -> shaft
demarcation -> demarcation
paul -> paul
rest -> rest
enrichment -> enrichment
novel -> novel
advancement -> advancement
relief -> relief
measurement -> measurement
monkey -> monkey
medallist -> medallist
editorial -> editorial
pear -> pear
story -> story
thorsten -> thorsten
cloud -> cloud
role -> role
libel -> libel
steven -> steven
stop -> stop
conference -> conference
dough -> dough
troupe -> troupe
stretch -> stretch
backlash -> backlash
disability -> disability
wagon -> wagon
sufficiency -> sufficiency
peacetime -> peacetime
modification -> modification
juror -> juror
sowing -> sowing
plutonium -> plutonium
flagship -> flagship
poker -> poker
peer -> peer
criticism -> criticism
systems -> systems
trivia -> trivia
manufacturing -> manufacturing
serving -> serving
headache -> headache
boundary -> boundary
visa -> visa
rank -> rank
car -> car
chopper -> chopper
exodus -> exodus
vendor -> vendor
typhoon -> typhoon
tower -> tower
valet -> valet
collision -> collision
stock fund -> stock#fund
boat -> boat
prison -> prison
ocean -> ocean
apparatus -> apparatus
stamp -> stamp
industrialist -> industrialist
antelope -> antelope
caucus -> caucus
substance -> substance
postmaster -> postmaster
member -> member
striker -> striker
bout -> bout
levin -> levin
garment -> garment
genome -> genome
picket -> picket
quiz -> quiz
vault -> vault
lance -> lance
ballet -> ballet
solvency -> solvency
dolphin -> dolphin
rogue -> rogue
fatality -> fatality
knee -> knee
comparison -> comparison
recordkeeping -> recordkeeping
factor -> factor
measles -> measles
sitcom -> sitcom
councillor -> councillor
bubble -> bubble
standardization -> standardization
department-store -> department#store
lending -> lending
sewage -> sewage
pleaser -> pleaser
ethanol -> ethanol
iodine -> iodine
velvet -> velvet
contracting -> contracting
warranty -> warranty
shit -> shit
research -> research
preservation -> preservation
junta -> junta
serpent -> serpent
youth -> youth
shipment -> shipment
dial tone -> dial#tone
countdown -> countdown
reinforcement -> reinforcement
thunderstorm -> thunderstorm
match -> match
reception -> reception
maturity -> maturity
size -> size
benefit -> benefit
spring -> spring
cylinder -> cylinder
barbecue -> barbecue
goat -> goat
degree -> degree
hierarchy -> hierarchy
connoisseur -> connoisseur
misdeed -> misdeed
acceleration -> acceleration
fight -> fight
sinus -> sinus
replay -> replay
bomb -> bomb
products -> products
departure -> departure
ovata -> ovata
reagan -> reagan
grace -> grace
kathy -> kathy
jungle -> jungle
belt -> belt
arrangement -> arrangement
genocide -> genocide
settler -> settler
childhood -> childhood
experience -> experience
master -> master
affiliate -> affiliate
shell -> shell
catering -> catering
cabinet -> cabinet
yes -> yes
expectation -> expectation
turkey -> turkey
cleric -> cleric
soundtrack -> soundtrack
chimney -> chimney
reaction -> reaction
showalter -> showalter
care -> care
eggs -> eggs
broiler -> broiler
newspaper -> newspaper
orange -> orange
eligibility -> eligibility
babe -> babe
parquet -> parquet
deadline -> deadline
beam -> beam
amount -> amount
value -> value
star -> star
evangelist -> evangelist
cathode -> cathode
nurse -> nurse
rebel -> rebel
interestrate -> interestrate
discounting -> discounting
debtor -> debtor
institute -> institute
investigation -> investigation
phase -> phase
cop -> cop
splinter -> splinter
meat -> meat
fears -> fears
gent -> gent
ride -> ride
farming -> farming
deadlock -> deadlock
vacuum -> vacuum
function -> function
obstruction -> obstruction
standoff -> standoff
availability -> availability
canvas -> canvas
scrap -> scrap
thrill -> thrill
timing -> timing
bourbon -> bourbon
teacher -> teacher
general -> general
ale -> ale
brokerage house -> brokerage#house
attachment -> attachment
miner -> miner
assembly -> assembly
brawl -> brawl
dialysis -> dialysis
species -> species
horsepower -> horsepower
essay -> essay
brokerage -> brokerage
spokeswoman -> spokeswoman
night -> night
nikov -> nikov
barrack -> barrack
strike force -> strike#force
lorry -> lorry
reforestation -> reforestation
cypress -> cypress
aerosol -> aerosol
admission -> admission
pair -> pair
stephan -> stephan
lump -> lump
gunshot -> gunshot
alternate -> alternate
breathing -> breathing
louse -> louse
relic -> relic
crop -> crop
mink -> mink
mix -> mix
reserve -> reserve
unit -> unit
conspiracy -> conspiracy
'80s -> '80s
siren -> siren
competitiveness -> competitiveness
lunch -> lunch
expiration -> expiration
bet -> bet
reactor -> reactor
redwood -> redwood
enforcement -> enforcement
dart -> dart
fatigue -> fatigue
permission -> permission
doubles -> doubles
relationship -> relationship
artifact -> artifact
spillover -> spillover
spy -> spy
special -> special
tracking -> tracking
tuxedo -> tuxedo
curbside -> curbside
solomon -> solomon
tow -> tow
confidence -> confidence
investor -> investor
coin -> coin
ringing -> ringing
illness -> illness
singles -> singles
reconnaissance -> reconnaissance
authorization -> authorization
functionary -> functionary
porn -> porn
female -> female
negotiation -> negotiation
ted -> ted
pregame -> pregame
color -> color
narcissism -> narcissism
vomica -> vomica
fiber -> fiber
superstring -> superstring
comrade -> comrade
outlaw -> outlaw
visitation -> visitation
trafficker -> trafficker
nonoperating -> nonoperating
forgery -> forgery
mainstream -> mainstream
repair -> repair
retention -> retention
fudging -> fudging
opening-up -> opening#up
irritation -> irritation
litre -> litre
bush -> bush
mayor -> mayor
forecast -> forecast
millionaire -> millionaire
soda -> soda
annuity -> annuity
listening -> listening
blindfold -> blindfold
climber -> climber
marketing -> marketing
turnover -> turnover
doctor -> doctor
violator -> violator
estrogen -> estrogen
copyright -> copyright
odyssey -> odyssey
seminar -> seminar
gentleman -> gentleman
feeder -> feeder
answering -> answering
pet -> pet
fowl -> fowl
autopsy -> autopsy
chemotherapy -> chemotherapy
air freight -> air#freight
bond -> bond
crime -> crime
cluster -> cluster
mystery -> mystery
expatriate -> expatriate
irrigation -> irrigation
chip -> chip
motor -> motor
weapon -> weapon
paper company -> paper#company
brake -> brake
refund -> refund
bearer -> bearer
rugby -> rugby
revolution -> revolution
fact -> fact
supplement -> supplement
seizure -> seizure
reservations -> reservations
commitment -> commitment
architect -> architect
overture -> overture
dress -> dress
wrestler -> wrestler
exclusion -> exclusion
hairline -> hairline
fixing -> fixing
blockbuster -> blockbuster
caution -> caution
deadend -> deadend
shipping -> shipping
rescission -> rescission
joy -> joy
hour -> hour
code -> code
fraternity -> fraternity
emigration -> emigration
bowl -> bowl
disk -> disk
'60s -> '60s
beetle -> beetle
ms. -> ms.
gas -> gas
suit -> suit
modem -> modem
accuracy -> accuracy
tartan -> tartan
luncheon -> luncheon
scheme -> scheme
mood -> mood
lobbying -> lobbying
doctorate -> doctorate
cathedral -> cathedral
exposure -> exposure
silverstein -> silverstein
reimbursement -> reimbursement
metal -> metal
belief -> belief
wort -> wort
teaspoon -> teaspoon
cuff -> cuff
paddy -> paddy
health care -> healthcare
river -> river
beachwear -> beachwear
tariff -> tariff
recreation -> recreation
land -> land
economy -> economy
force -> force
imagery -> imagery
end -> end
crawler -> crawler
stroke -> stroke
cargo -> cargo
cost -> cost
breaker -> breaker
unity -> unity
casting -> casting
lawn -> lawn
antifreeze -> antifreeze
equestrian -> equestrian
depth -> depth
client -> client
reconstruction -> reconstruction
cooker -> cooker
jersey -> jersey
privatisation -> privatisation
slipper -> slipper
insecurity -> insecurity
barricade -> barricade
obama -> obama
wolf -> wolf
niche -> niche
borough -> borough
apnea -> apnea
polygraph -> polygraph
arrow -> arrow
interrogation -> interrogation
ezra -> ezra
cry -> cry
import -> import
graphite -> graphite
gold -> gold
spread -> spread
poultry -> poultry
skiing -> skiing
bunt -> bunt
refuge -> refuge
biotech -> biotech
command -> command
kickoff -> kickoff
smelter -> smelter
cutthroat -> cutthroat
flame -> flame
promise -> promise
diabetes -> diabetes
rotator -> rotator
satellite -> satellite
alphabet -> alphabet
precision -> precision
cadet -> cadet
barrage -> barrage
punt -> punt
backpack -> backpack
cease -> cease
morning -> morning
morigawa -> morigawa
pearl -> pearl
age -> age
sensibility -> sensibility
nature -> nature
high-yield -> high#yield
ineptitude -> ineptitude
nylon -> nylon
pal -> pal
tanker -> tanker
devil -> devil
bungee -> bungee
excutives -> excutives
penalty -> penalty
snowboarder -> snowboarder
toupee -> toupee
clan -> clan
cholesterol -> cholesterol
carnival -> carnival
restrictor -> restrictor
judiciary -> judiciary
pyschology -> pyschology
use -> use
ecstasy -> ecstasy
matter -> matter
standing -> standing
lender -> lender
mercury -> mercury
cheerleader -> cheerleader
malefactor -> malefactor
shoplifting -> shoplifting
widow -> widow
tofu -> tofu
official -> official
adaptation -> adaptation
provider -> provider
yeast -> yeast
ebola -> ebola
sacrifice -> sacrifice
earring -> earring
symposium -> symposium
circus -> circus
stampings -> stampings
pill -> pill
stabilization -> stabilization
integrator -> integrator
disposal -> disposal
linebacker -> linebacker
fancier -> fancier
chairman -> chairman
petrol -> petrol
constraint -> constraint
jail -> jail
shrub -> shrub
communications -> communications
squeeze -> squeeze
hydrochloride -> hydrochloride
tycoon -> tycoon
wound -> wound
shellfish -> shellfish
leather -> leather
plaintiff -> plaintiff
primary -> primary
jalapeno -> jalapeno
rampage -> rampage
forest -> forest
gouging -> gouging
bias -> bias
library -> library
katherine -> katherine
diamond -> diamond
bang -> bang
jet -> jet
packer -> packer
newscast -> newscast
exercise -> exercise
score -> score
barrel -> barrel
garbage -> garbage
vacation -> vacation
coastguard -> coastguard
afforestation -> afforestation
window -> window
ethics -> ethics
husk -> husk
gallon -> gallon
pick -> pick
printout -> printout
torricelli -> torricelli
conservation -> conservation
suspension -> suspension
booster -> booster
halter -> halter
one-out -> one#out
cereal -> cereal
frat -> frat
muscle -> muscle
cat -> cat
rice -> rice
pennant -> pennant
wheel -> wheel
feedlot -> feedlot
hue -> hue
robbery -> robbery
communique -> communique
utilities -> utilities
life -> life
suggestion -> suggestion
saucepan -> saucepan
prosecution -> prosecution
represenative -> represenative
operating -> operating
grandmother -> grandmother
workstation -> workstation
erosion -> erosion
importation -> importation
inequality -> inequality
rotation -> rotation
mouse -> mouse
liquidation -> liquidation
wood -> wood
vote -> vote
patio -> patio
magistrate -> magistrate
midterm -> midterm
guard -> guard
trash -> trash
shade -> shade
accountancy -> accountancy
arcade -> arcade
birdie -> birdie
exerciser -> exerciser
script -> script
saucer -> saucer
pneumonia -> pneumonia
defender -> defender
aaron -> aaron
submission -> submission
sipper -> sipper
bullet -> bullet
grunt -> grunt
dam -> dam
island -> island
top-10 -> top#10
passing -> passing
twisting -> twisting
landscape -> landscape
addition -> addition
geek -> geek
groin -> groin
activation -> activation
majority -> majority
content -> content
larry -> larry
issues -> issues
contamination -> contamination
speech -> speech
contempt -> contempt
siege -> siege
anthony -> anthony
start up -> startup
backpacker -> backpacker
benzethonium -> benzethonium
lieutenant -> lieutenant
expansionist -> expansionist
thomas -> thomas
miles -> miles
sound -> sound
fellow -> fellow
administrator -> administrator
recall -> recall
infighting -> infighting
infection -> infection
runway -> runway
planting -> planting
downside -> downside
flannel -> flannel
composer -> composer
hysteria -> hysteria
swaps -> swaps
duty -> duty
production -> production
traveler -> traveler
sympathy -> sympathy
infertility -> infertility
eater -> eater
combination -> combination
evacuation -> evacuation
soft drink -> soft_drink
pastoris -> pastoris
evasion -> evasion
immigration -> immigration
hunting -> hunting
variety -> variety
metro -> metro
selection -> selection
stimulant -> stimulant
referendum -> referendum
aide -> aide
excreta -> excreta
stipend -> stipend
juggling -> juggling
claims -> claims
cream -> cream
lobster -> lobster
living -> living
pipe -> pipe
training -> training
arms-for-hostages -> arms#for#hostages
consultancy -> consultancy
contact -> contact
processing -> processing
museum -> museum
base -> base
nursing home -> nursing#home
settlement -> settlement
tuna -> tuna
petroleum -> petroleum
gender -> gender
pole -> pole
gold leaf -> gold#leaf
williams -> williams
message -> message
mister -> mister
elixir -> elixir
nerve -> nerve
predecessor -> predecessor
note -> note
graduate -> graduate
listeria -> listeria
entertainment -> entertainment
kickback -> kickback
subsidiary -> subsidiary
condition -> condition
freestyle -> freestyle
plastics -> plastics
cartridge -> cartridge
vehicle -> vehicle
carmen -> carmen
relative -> relative
term -> term
roadblock -> roadblock
paratrooper -> paratrooper
turban -> turban
tabloid -> tabloid
logging -> logging
verdict -> verdict
services -> services
recipient -> recipient
friendship -> friendship
taste -> taste
assistance -> assistance
difficulty -> difficulty
irony -> irony
grudge -> grudge
life insurance -> life#insurance
distance -> distance
endorsement -> endorsement
rent -> rent
shuttle -> shuttle
bookshop -> bookshop
passage -> passage
buildup -> buildup
working girl -> working#girl
lineup -> lineup
airlines -> airlines
alex -> alex
introduction -> introduction
rubber -> rubber
reservation -> reservation
deer -> deer
mcveigh -> mcveigh
consideration -> consideration
battery -> battery
mite -> mite
infrastructure -> infrastructure
schoolmarm -> schoolmarm
bumper -> bumper
roll -> roll
page -> page
advocate -> advocate
policy -> policy
tension -> tension
incarceration -> incarceration
butter -> butter
episode -> episode
translation -> translation
port -> port
toll -> toll
crap -> crap
nonpayment -> nonpayment
protection -> protection
order -> order
vaccine -> vaccine
megawatt -> megawatt
medium -> medium
accession -> accession
medicare -> medicare
tribe -> tribe
article -> article
transplant -> transplant
biodiversity -> biodiversity
heartland -> heartland
teaspoons -> teaspoons
handgun -> handgun
dioxide -> dioxide
high -> high
software -> software
hanger -> hanger
glove -> glove
boys -> boys
park -> park
worker -> worker
feasibility -> feasibility
hospitalization -> hospitalization
misuse -> misuse
fluoride -> fluoride
sniper -> sniper
bath -> bath
performer -> performer
bonding -> bonding
quarterback -> quarterback
theory -> theory
glut -> glut
cloth -> cloth
matsui -> matsui
josh -> josh
bird -> bird
council -> council
sprint -> sprint
mover -> mover
tablet -> tablet
bureaucracy -> bureaucracy
crumb -> crumb
reinsurance -> reinsurance
peddling -> peddling
flask -> flask
covenant -> covenant
inkjet -> inkjet
tobacco -> tobacco
campaign -> campaign
thatcher -> thatcher
pellet -> pellet
presentation -> presentation
promotion -> promotion
hygiene -> hygiene
stimulus -> stimulus
sewer -> sewer
kohlberg -> kohlberg
turbulence -> turbulence
breakdown -> breakdown
dormitory -> dormitory
razor -> razor
plunge -> plunge
offspring -> offspring
arena -> arena
assessment -> assessment
desalination -> desalination
label -> label
apricot -> apricot
bond trading -> bond#trading
utilization -> utilization
gunman -> gunman
mobility -> mobility
blues -> blues
foot -> foot
supplier -> supplier
tragedy -> tragedy
pregnancy -> pregnancy
strobe -> strobe
saga -> saga
fozzy -> fozzy
freeze -> freeze
downtown -> downtown
real-estate -> real_estate
loot -> loot
freshwater -> freshwater
houseplant -> houseplant
impairment -> impairment
umbrella -> umbrella
breakfast -> breakfast
salicylate -> salicylate
skill -> skill
lebowski -> lebowski
brace -> brace
technocrat -> technocrat
pains -> pains
twin-deficit -> twin#deficit
profanity -> profanity
president -> president
framework -> framework
videoconferencing -> videoconferencing
movie -> movie
cherry -> cherry
crystal -> crystal
breakup -> breakup
residue -> residue
determination -> determination
minimum -> minimum
fitness -> fitness
apparel -> apparel
magnate -> magnate
market-maker -> market#maker
watch -> watch
liter -> liter
breaking -> breaking
depression -> depression
bunny -> bunny
schedule -> schedule
winter -> winter
reversal -> reversal
restructuring -> restructuring
inflation -> inflation
lode -> lode
adler -> adler
intermediary -> intermediary
shoulder -> shoulder
cyanide -> cyanide
pitching -> pitching
hospital -> hospital
spot -> spot
fashion -> fashion
rose -> rose
hideaway -> hideaway
fighting -> fighting
valve -> valve
vladimir -> vladimir
payback -> payback
transfer -> transfer
stage -> stage
forrestor -> forrestor
fireproofing -> fireproofing
massage -> massage
noise -> noise
root canal -> root_canal
creation -> creation
modernization -> modernization
capital -> capital
total -> total
cholera -> cholera
girls -> girls
wire -> wire
illustration -> illustration
directive -> directive
population -> population
capitalism -> capitalism
camouflage -> camouflage
track -> track
railroad -> railroad
sheet -> sheet
healer -> healer
crown -> crown
goody -> goody
assault -> assault
overhead -> overhead
royalist -> royalist
softener -> softener
season -> season
repression -> repression
attention -> attention
sr. -> sr.
dawn -> dawn
station -> station
gesture -> gesture
zeal -> zeal
bottler -> bottler
zoo -> zoo
fighter -> fighter
flooding -> flooding
keyboard -> keyboard
bleacher -> bleacher
hdtv -> hdtv
decline -> decline
row -> row
immigrant -> immigrant
coaching -> coaching
discovery -> discovery
actor -> actor
straw -> straw
mat -> mat
grilling -> grilling
squash -> squash
press -> press
network -> network
landing -> landing
vu -> vu
district -> district
debut -> debut
marquee -> marquee
thread -> thread
accountant -> accountant
domino -> domino
loyalist -> loyalist
mill -> mill
amphetamine -> amphetamine
city -> city
repurchase -> repurchase
intestine -> intestine
landmark -> landmark
launch -> launch
lithography -> lithography
figure -> figure
republican -> republican
futures -> futures
negotiator -> negotiator
theme -> theme
asset -> asset
nine -> nine
move -> move
centerpiece -> centerpiece
wilderness -> wilderness
furnishing -> furnishing
apartment -> apartment
homocysteine -> homocysteine
landslide -> landslide
tire -> tire
main -> main
arthritis -> arthritis
tornado -> tornado
seller -> seller
buffer -> buffer
angiogenesis -> angiogenesis
mileage -> mileage
standard -> standard
conditioner -> conditioner
hedge -> hedge
rival -> rival
diagnosis -> diagnosis
politicking -> politicking
schmoozing -> schmoozing
love -> love
silt -> silt
dominance -> dominance
sobriety -> sobriety
obscenity -> obscenity
voucher -> voucher
chemical -> chemical
profile -> profile
jailhouse -> jailhouse
subsidy -> subsidy
reggie -> reggie
expiry -> expiry
midnight -> midnight
precursor -> precursor
destination -> destination
spinach -> spinach
artillery -> artillery
liquid nitrogen -> liquid_nitrogen
gag -> gag
soldier -> soldier
trails -> trails
mechanism -> mechanism
extortion -> extortion
espionage -> espionage
tractor-trailer -> tractor_trailer
home building -> home#building
tightness -> tightness
leasing -> leasing
distribution -> distribution
bail -> bail
guidance -> guidance
taxi -> taxi
non-member -> non#member
girder -> girder
inspection -> inspection
dispatcher -> dispatcher
heavy truck -> heavy#truck
immunization -> immunization
shirt -> shirt
matching -> matching
destruction -> destruction
infestation -> infestation
consul -> consul
penetration -> penetration
dirt -> dirt
gravel -> gravel
while -> while
tribesman -> tribesman
ticket -> ticket
upbringing -> upbringing
bomber -> bomber
leukemia -> leukemia
slump -> slump
militia -> militia
grinder -> grinder
filmmaker -> filmmaker
candy -> candy
oliver -> oliver
ronald -> ronald
lot -> lot
chamber -> chamber
field -> field
directory -> directory
spying -> spying
corps -> corps
chemistry -> chemistry
sandwich -> sandwich
deposit -> deposit
sabotage -> sabotage
deputy -> deputy
roaster -> roaster
subsistence -> subsistence
fetishism -> fetishism
audience -> audience
alpaca -> alpaca
tour -> tour
dock -> dock
artichoke -> artichoke
cancer -> cancer
pilot -> pilot
rehab -> rehab
peace -> peace
sympathizer -> sympathizer
ricotta -> ricotta
freeway -> freeway
anxiety -> anxiety
party -> party
speaker -> speaker
insider -> insider
liability -> liability
anchovy -> anchovy
rooftop -> rooftop
symptom -> symptom
roulette -> roulette
agency -> agency
acreage -> acreage
treadmill -> treadmill
focus -> focus
bench -> bench
driving -> driving
liberation -> liberation
diet -> diet
mortgage -> mortgage
pants -> pants
wholesaler -> wholesaler
cigarette -> cigarette
industry -> industry
attache -> attache
casserole -> casserole
relocation -> relocation
rustling -> rustling
trick -> trick
foodstuff -> foodstuff
identity -> identity
hydrogen -> hydrogen
splitting -> splitting
civics -> civics
alien -> alien
feeling -> feeling
politburo -> politburo
dean -> dean
dentist -> dentist
background -> background
elevator -> elevator
seat -> seat
compression -> compression
anger -> anger
adjustment -> adjustment
transaction -> transaction
capacity -> capacity
disease -> disease
cocktail -> cocktail
geography -> geography
towel -> towel
shelter -> shelter
shooter -> shooter
bass -> bass
astronomy -> astronomy
freak -> freak
programming -> programming
pay -> pay
fuel -> fuel
bike -> bike
house -> house
backroom -> backroom
duel -> duel
smashing -> smashing
recess -> recess
kidnapping -> kidnapping
census -> census
rail -> rail
mozzarella -> mozzarella
tin -> tin
return -> return
notebook -> notebook
judgment -> judgment
balancing -> balancing
sponsor -> sponsor
communist -> communist
work -> work
insurgent -> insurgent
staphylococcus -> staphylococcus
part -> part
chess -> chess
schoolboy -> schoolboy
offender -> offender
pilgrim -> pilgrim
escrow -> escrow
dollar -> dollar
symbol -> symbol
memorial -> memorial
bid -> bid
sprinkler -> sprinkler
franklin -> franklin
bud -> bud
point -> point
brantz -> brantz
doctrine -> doctrine
hangar -> hangar
reorganisation -> reorganisation
interceptor -> interceptor
economist -> economist
hiking -> hiking
bulb -> bulb
snow -> snow
month -> month
sen. -> sen.
mob -> mob
decree -> decree
hillside -> hillside
currencny -> currencny
senior -> senior
sand -> sand
redneck -> redneck
execution -> execution
rise -> rise
successor -> successor
edition -> edition
retailer -> retailer
animal -> animal
china -> china
fetal tissue -> fetal_tissue
wrench -> wrench
shutdown -> shutdown
bandanna -> bandanna
laser -> laser
vine -> vine
caster -> caster
nux -> nux
corporation -> corporation
pizza -> pizza
wind -> wind
rebuilding -> rebuilding
rearing -> rearing
painting -> painting
future -> future
rook -> rook
merger -> merger
shopping -> shopping
building -> building
linage -> linage
bulldog -> bulldog
riot -> riot
right -> right
employer -> employer
anti-intellectualism -> anti_intellectualism
recipe -> recipe
litigation -> litigation
owl -> owl
finish -> finish
ball -> ball
iron -> iron
intraday -> intraday
gap -> gap
candidate -> candidate
stalemate -> stalemate
giant -> giant
workout -> workout
drilling -> drilling
account -> account
aids -> aids
humor -> humor
pricing -> pricing
microphone -> microphone
bestseller -> bestseller
shear -> shear
ultrasound -> ultrasound
reporter -> reporter
surgery -> surgery
skin -> skin
hate -> hate
frenzy -> frenzy
tip -> tip
disappointment -> disappointment
pedestrian -> pedestrian
sulfur -> sulfur
halt -> halt
carrot -> carrot
weighting -> weighting
talent -> talent
staph -> staph
gelatin -> gelatin
stream -> stream
beginning -> beginning
scrip -> scrip
opening -> opening
boyhood -> boyhood
coordinator -> coordinator
video -> video
guru -> guru
patterson -> patterson
cookie -> cookie
sweep -> sweep
democracy -> democracy
corruption -> corruption
truck -> truck
conveyor -> conveyor
flow -> flow
pickup -> pickup
lawmaker -> lawmaker
soup -> soup
supremacist -> supremacist
curfew -> curfew
malpractice -> malpractice
basin -> basin
aramid -> aramid
renegade -> renegade
status -> status
stockpile -> stockpile
blitz -> blitz
concern -> concern
chest -> chest
excerpt -> excerpt
core -> core
bookcase -> bookcase
boarding -> boarding
charity -> charity
investigating -> investigating
era -> era
katz -> katz
fruit -> fruit
low -> low
computer -> computer
farmer -> farmer
leading -> leading
glass -> glass
parcel -> parcel
consequence -> consequence
reunification -> reunification
treason -> treason
lifesaving -> lifesaving
constrictor -> constrictor
coast -> coast
emission -> emission
trauma -> trauma
congress -> congress
abduction -> abduction
warp -> warp
density -> density
flick -> flick
sentiment -> sentiment
geologist -> geologist
placement -> placement
stand -> stand
purse -> purse
permit -> permit
co-chief -> co#chief
hit -> hit
shoot -> shoot
eagle -> eagle
deal -> deal
efficiency -> efficiency
outfield -> outfield
surgeon -> surgeon
obstacle -> obstacle
prime -> prime
cleanup -> cleanup
attempt -> attempt
joseph -> joseph
sender -> sender
scenario -> scenario
buy -> buy
tax loss -> tax#loss
activism -> activism
peanut -> peanut
gourmet -> gourmet
duck -> duck
computing -> computing
queen -> queen
pipeline -> pipeline
cod -> cod
batting -> batting
triangle -> triangle
fear -> fear
witch -> witch
shotgun -> shotgun
snowball -> snowball
grassroot -> grassroot
campaigner -> campaigner
marketplace -> marketplace
shopper -> shopper
composting -> composting
shoestring -> shoestring
greeting -> greeting
edmond -> edmond
syphilis -> syphilis
columnist -> columnist
application -> application
jock -> jock
procedure -> procedure
fossil -> fossil
average -> average
drafting -> drafting
piranha -> piranha
empire -> empire
terms -> terms
share -> share
locust -> locust
stone -> stone
contingency -> contingency
broncs -> broncs
augmentation -> augmentation
planning -> planning
restriction -> restriction
gilt -> gilt
declaration -> declaration
inflammation -> inflammation
grater -> grater
airport -> airport
development -> development
lighting -> lighting
third-quarter -> third#quarter
one-third -> one#third
split -> split
project -> project
speculation -> speculation
manual -> manual
recognition -> recognition
multimedia -> multimedia
guidebook -> guidebook
apathy -> apathy
texture -> texture
top -> top
class -> class
gadget -> gadget
seyer -> seyer
sprout -> sprout
chain -> chain
ligament -> ligament
reinvestment -> reinvestment
lockout -> lockout
grain -> grain
deep -> deep
classified -> classified
shrimp -> shrimp
antibody -> antibody
toe -> toe
vaccination -> vaccination
counterintelligence -> counterintelligence
stock-market -> stock#market
euthanasia -> euthanasia
survivor -> survivor
concentrate -> concentrate
sorghum -> sorghum
depository -> depository
wicker -> wicker
room -> room
musicianship -> musicianship
clone -> clone
range -> range
polio -> polio
lumber -> lumber
rebecca -> rebecca
write-off -> write#off
auditorium -> auditorium
mafia -> mafia
receiver -> receiver
irregularity -> irregularity
defamation -> defamation
peters -> peters
rag -> rag
monster -> monster
contractor -> contractor
assassin -> assassin
airworthiness -> airworthiness
batch -> batch
asylum -> asylum
liaison -> liaison
cycle -> cycle
penny -> penny
enclave -> enclave
fan -> fan
band -> band
cough -> cough
fair -> fair
lease -> lease
yarn -> yarn
warning -> warning
advisor -> advisor
barrier -> barrier
defeat -> defeat
commencement -> commencement
body -> body
bullpen -> bullpen
sprain -> sprain
dealership -> dealership
pant -> pant
latex -> latex
bankers -> bankers
offer -> offer
paper -> paper
index -> index
rancher -> rancher
year -> year
powder -> powder
drag -> drag
hula -> hula
cord -> cord
completion -> completion
coloratura -> coloratura
machine -> machine
kitchen -> kitchen
backyard -> backyard
simulation -> simulation
prize -> prize
atrocity -> atrocity
education -> education
advertising -> advertising
pam -> pam
reservoir -> reservoir
teen -> teen
docket -> docket
realtor -> realtor
guitarist -> guitarist
temperature -> temperature
naif -> naif
disaster -> disaster
stability -> stability
profession -> profession
statement -> statement
northeast -> northeast
kms -> kms
principle -> principle
palladium -> palladium
patrician -> patrician
syrup -> syrup
staple -> staple
drugstore -> drugstore
engine -> engine
statue -> statue
mutilation -> mutilation
saint -> saint
improvement -> improvement
respectability -> respectability
dump -> dump
inspector -> inspector
scandal -> scandal
mining -> mining
statehood -> statehood
penguin -> penguin
write-down -> write#down
corrections -> corrections
desktop -> desktop
censorship -> censorship
energy cogeneration -> energy#cogeneration
trumpet -> trumpet
centerfield -> centerfield
sexuality -> sexuality
surrender -> surrender
portrait -> portrait
synagogue -> synagogue
change -> change
gutter -> gutter
at-bat -> at#bat
stockholder -> stockholder
user -> user
identification -> identification
comments -> comments
gem -> gem
danger -> danger
asbestos -> asbestos
felony -> felony
tide -> tide
debra -> debra
plantation -> plantation
builder -> builder
quality -> quality
mile -> mile
desk -> desk
specialist -> specialist
grape -> grape
catherine -> catherine
pre-tax -> pretax
schmidt -> schmidt
beverage -> beverage
basement -> basement
running -> running
telecommunications -> telecommunications
cup -> cup
ginger -> ginger
perkins -> perkins
tantrum -> tantrum
companion -> companion
space station -> space#station
provision -> provision
eradication -> eradication
sales -> sales
superpower -> superpower
mushroom -> mushroom
organ -> organ
fountain -> fountain
secret -> secret
pork -> pork
umpire -> umpire
kiwi -> kiwi
cable -> cable
molecule -> molecule
classification -> classification
wreck -> wreck
frontier -> frontier
ripple -> ripple
ladybug -> ladybug
ankle -> ankle
dining -> dining
subcompact -> subcompact
kebab -> kebab
bite -> bite
culture -> culture
pin -> pin
finding -> finding
airplane -> airplane
governor -> governor
possibility -> possibility
mountain -> mountain
donor -> donor
high-society -> high#society
patch -> patch
challenge -> challenge
freight -> freight
beer -> beer
strength -> strength
insulation -> insulation
pond -> pond
rib -> rib
oil-leasing -> oil#leasing
lecture -> lecture
harrington -> harrington
vermin -> vermin
petraeus -> petraeus
protocol -> protocol
adversary -> adversary
caretaker -> caretaker
fastbreak -> fastbreak
worth -> worth
amnesty -> amnesty
tactic -> tactic
academy -> academy
cow -> cow
jones -> jones
goodwill -> goodwill
spielberg -> spielberg
abalone -> abalone
announcement -> announcement
healing -> healing
origination -> origination
organized crime -> organized#crime
grocer -> grocer
panic -> panic
mideast -> mideast
package -> package
arbitrage -> arbitrage
convenience -> convenience
sculptor -> sculptor
redemption -> redemption
front runner -> front#runner
choice -> choice
drive -> drive
travel -> travel
economics -> economics
constable -> constable
nichols -> nichols
utilisation -> utilisation
specie -> specie
tailgate -> tailgate
coup -> coup
steel -> steel
saving -> saving
banks -> banks
psychology -> psychology
host -> host
problem -> problem
debenture -> debenture
forestry -> forestry
fraud -> fraud
barter -> barter
lion -> lion
classic -> classic
butt -> butt
courtroom -> courtroom
achievement -> achievement
gale -> gale
utensil -> utensil
property -> property
strike -> strike
salesman -> salesman
grove -> grove
adviser -> adviser
chenille -> chenille
sequence -> sequence
robe -> robe
binge -> binge
darling -> darling
watkins -> watkins
budgeting -> budgeting
cocaine -> cocaine
slate -> slate
cabin -> cabin
resin -> resin
outpost -> outpost
legislation -> legislation
support -> support
forum -> forum
reading -> reading
view -> view
feedback -> feedback
siding -> siding
conviction -> conviction
organization -> organization
form -> form
minivan -> minivan
underwriter -> underwriter
mixture -> mixture
repeat -> repeat
burglary -> burglary
bathroom -> bathroom
grave -> grave
survival -> survival
km -> km
distributor -> distributor
catcher -> catcher
chasing -> chasing
cinnamon -> cinnamon
navigation -> navigation
ax -> ax
extradition -> extradition
sickness -> sickness
laboratory -> laboratory
cosmetics -> cosmetics
rabies -> rabies
burner -> burner
demo -> demo
emergency -> emergency
bunker -> bunker
clearing -> clearing
picture -> picture
award -> award
sightseeing -> sightseeing
memory -> memory
circle -> circle
period -> period
air -> air
racism -> racism
greed -> greed
fur -> fur
olive -> olive
bronze -> bronze
penitentiary -> penitentiary
assets -> assets
broadcast -> broadcast
sensor -> sensor
bacterium -> bacterium
networking -> networking
vapor -> vapor
feminist -> feminist
output -> output
machete -> machete
estimate -> estimate
peddler -> peddler
nationalist -> nationalist
personnel -> personnel
independence -> independence
situation -> situation
crunch -> crunch
grazing -> grazing
consultation -> consultation
minutes -> minutes
erotica -> erotica
cast -> cast
fault -> fault
sniffer -> sniffer
valuation -> valuation
manning -> manning
fourth-quarter -> fourth#quarter
fireplace -> fireplace
ensemble -> ensemble
ploy -> ploy
plainclothes -> plainclothes
generation -> generation
profit -> profit
shareholding -> shareholding
soy -> soy
tightening -> tightening
shortwave -> shortwave
petal -> petal
staff -> staff
reporting -> reporting
gold mining -> gold#mining
musket -> musket
buyout -> buyout
explosion -> explosion
evening -> evening
lawyer -> lawyer
meal -> meal
firearm -> firearm
resident -> resident
firma -> firma
jump -> jump
notice -> notice
stab -> stab
skillet -> skillet
midair -> midair
steroid -> steroid
birth -> birth
volleyball -> volleyball
christopher -> christopher
slurry -> slurry
cliff -> cliff
biologist -> biologist
oat -> oat
millennium -> millennium
stadium -> stadium
avoidance -> avoidance
containment -> containment
maple -> maple
cleavage -> cleavage
replacement -> replacement
allowance -> allowance
speed -> speed
appliance -> appliance
coffee shop -> coffee_shop
theology -> theology
bum -> bum
firefighter -> firefighter
pusher -> pusher
artery -> artery
event -> event
bakery -> bakery
pollution -> pollution
orchard -> orchard
non-warranty -> non#warranty
paraphernalia -> paraphernalia
reward -> reward
race -> race
runoff -> runoff
conflict -> conflict
making -> making
banquet -> banquet
flak -> flak
membership -> membership
emeritus -> emeritus
fax -> fax
sibling -> sibling
cover -> cover
platinum -> platinum
ballroom -> ballroom
enthusiasm -> enthusiasm
yen -> yen
plains -> plains
floating rate -> floating#rate
popularity -> popularity
defect -> defect
bark -> bark
conservative -> conservative
balance -> balance
position -> position
residency -> residency
autumn -> autumn
brad -> brad
food -> food
scammer -> scammer
attorney -> attorney
wildlife -> wildlife
leaf -> leaf
worries -> worries
division -> division
mrs. -> mrs.
loan -> loan
printer -> printer
jumper -> jumper
absorber -> absorber
tray -> tray
bottom -> bottom
parish -> parish
sermon -> sermon
eleanor -> eleanor
starvation -> starvation
arbitration -> arbitration
suite -> suite
cage -> cage
etiquette -> etiquette
citation -> citation
kit -> kit
leak -> leak
stick -> stick
university -> university
warrior -> warrior
door -> door
pullback -> pullback
insanity -> insanity
ministry -> ministry
diplomacy -> diplomacy
lightning -> lightning
insurgency -> insurgency
management -> management
purification -> purification
ratification -> ratification
bed -> bed
service -> service
bargain -> bargain
mosque -> mosque
reason -> reason
toxicology -> toxicology
paste -> paste
tree -> tree
concert -> concert
association -> association
harassment -> harassment
mogul -> mogul
nomination -> nomination
lotion -> lotion
modifier -> modifier
check -> check
township -> township
meters -> meters
limit -> limit
hunter -> hunter
plan -> plan
brain -> brain
van -> van
escort -> escort
hockey -> hockey
kirsten -> kirsten
set -> set
misdemeanor -> misdemeanor
sporting -> sporting
vitamin -> vitamin
taker -> taker
redevelopment -> redevelopment
chart -> chart
cutback -> cutback
expertise -> expertise
yuppie -> yuppie
teaching -> teaching
cashmere -> cashmere
outing -> outing
crossing -> crossing
opportunity -> opportunity
baron -> baron
mediation -> mediation
documentary -> documentary
announcer -> announcer
daylight -> daylight
stress -> stress
removal -> removal
psychologist -> psychologist
alice -> alice
consortia -> consortia
atmosphere -> atmosphere
football -> football
reservist -> reservist
practice -> practice
fluctuation -> fluctuation
hacker -> hacker
fir -> fir
rape -> rape
attendance -> attendance
delay -> delay
limousine -> limousine
mapping -> mapping
prostitute -> prostitute
pump -> pump
heading -> heading
veteran -> veteran
trophy -> trophy
renewal -> renewal
holiday -> holiday
intelligence -> intelligence
leisure -> leisure
purchasing -> purchasing
slice -> slice
inn -> inn
dramas -> dramas
indictment -> indictment
foster child -> foster#child
redistribution -> redistribution
contingent -> contingent
law enforcement -> law_enforcement
journalist -> journalist
midrange -> midrange
chaos -> chaos
enemy -> enemy
cowgirl -> cowgirl
rehabilitation -> rehabilitation
graduation -> graduation
legislator -> legislator
drought -> drought
choir -> choir
process -> process
chairmanship -> chairmanship
percentage -> percentage
wage -> wage
filler -> filler
sodomy -> sodomy
cookbook -> cookbook
dishonesty -> dishonesty
people -> people
fiction -> fiction
fungus -> fungus
heavyweight -> heavyweight
chainsaw -> chainsaw
tuition -> tuition
reference -> reference
accountability -> accountability
collector -> collector
electrode -> electrode
bladder -> bladder
demonstrator -> demonstrator
oblast -> oblast
confidentiality -> confidentiality
browser -> browser
gunfire -> gunfire
requirement -> requirement
vessel -> vessel
healthcare -> healthcare
sun -> sun
trust -> trust
gene -> gene
calm -> calm
secrecy -> secrecy
loading -> loading
squadron -> squadron
firework -> firework
hurdle -> hurdle
flood -> flood
card -> card
last -> last
pack -> pack
kilometer -> kilometer
chemicals -> chemicals
hub -> hub
watershed -> watershed
credits -> credits
graphics -> graphics
doldrums -> doldrums
vinegar -> vinegar
procession -> procession
canal -> canal
benchmark -> benchmark
rehearsal -> rehearsal
interagency -> interagency
generosity -> generosity
hope -> hope
sanchez -> sanchez
addiction -> addiction
sentence -> sentence
mouth -> mouth
diaper -> diaper
delinquent -> delinquent
burial -> burial
transit -> transit
speechwriter -> speechwriter
weekend -> weekend
sellers -> sellers
chat -> chat
businessman -> businessman
phone -> phone
fishery -> fishery
pepper -> pepper
vigilante -> vigilante
junkie -> junkie
salmonella -> salmonella
commissioner -> commissioner
terra -> terra
battleground -> battleground
agreement -> agreement
animation -> animation
dinosaur -> dinosaur
bombing -> bombing
appointment -> appointment
small business -> small#business
mopping-up -> mopping#up
wig -> wig
stool -> stool
wiretap -> wiretap
fairway -> fairway
savings -> savings
household -> household
democratization -> democratization
bikini -> bikini
payer -> payer
polyester -> polyester
activity -> activity
superintendent -> superintendent
tyler -> tyler
actress -> actress
brian -> brian
payment -> payment
civilization -> civilization
pretax -> pretax
plain -> plain
poster -> poster
lifestyle -> lifestyle
desegregation -> desegregation
compartment -> compartment
container -> container
rescue -> rescue
hairdo -> hairdo
woodward -> woodward
probation -> probation
garage -> garage
meteor -> meteor
trade -> trade
violin -> violin
alumni -> alumni
radiation -> radiation
toad -> toad
antique -> antique
ramp -> ramp
pandemic -> pandemic
design -> design
birthday -> birthday
oversight -> oversight
joint -> joint
drinking -> drinking
duct -> duct
proportion -> proportion
stance -> stance
greenhouse -> greenhouse
honor -> honor
robber -> robber
telecommunication -> telecommunication
anticipation -> anticipation
pot -> pot
craft -> craft
renter -> renter
vulture -> vulture
regular -> regular
collective -> collective
bin -> bin
shareware -> shareware
reorganization -> reorganization
hedging -> hedging
verification -> verification
ruling -> ruling
honey -> honey
armistice -> armistice
filtration -> filtration
center -> center
indemnity -> indemnity
archive -> archive
vice -> vice
partner -> partner
curb -> curb
spraying -> spraying
request -> request
unrest -> unrest
lock -> lock
victor -> victor
digger -> digger
plagiarism -> plagiarism
income tax -> income#tax
play -> play
bacteria -> bacteria
heirloom -> heirloom
state -> state
biscuit -> biscuit
jacket -> jacket
poppy -> poppy
control -> control
taxpayer -> taxpayer
nutrition -> nutrition
takeover -> takeover
plywood -> plywood
peak -> peak
money -> money
reprieve -> reprieve
link -> link
buddy -> buddy
approval -> approval
ransom -> ransom
ski -> ski
magnolia -> magnolia
hog -> hog
segmentation -> segmentation
co-manager -> co#manager
session -> session
designer -> designer
facility -> facility
blast -> blast
crash -> crash
rule -> rule
prefix -> prefix
warden -> warden
option -> option
gunfight -> gunfight
outlay -> outlay
reset -> reset
fetish -> fetish
thrower -> thrower
benjamin -> benjamin
rebuttal -> rebuttal
brisket -> brisket
legislature -> legislature
sleep -> sleep
income -> income
dunk -> dunk
imprisonment -> imprisonment
key -> key
ban -> ban
terminal -> terminal
oil -> oil
bucket -> bucket
upper income -> upper#income
flea -> flea
aspect -> aspect
stucco -> stucco
necktie -> necktie
step -> step
hardwood -> hardwood
bankruptcy law -> bankruptcy#law
customs -> customs
offering -> offering
lymph -> lymph
sunflower -> sunflower
soap -> soap
fujimori -> fujimori
preparedness -> preparedness
engineering -> engineering
kennedy -> kennedy
additive -> additive
hose -> hose
chill -> chill
rain -> rain
dirk -> dirk
accounting -> accounting
highlight -> highlight
constitution -> constitution
mussel -> mussel
flu -> flu
supervisor -> supervisor
lift -> lift
camping -> camping
drug -> drug
hoop -> hoop
spreadsheet -> spreadsheet
shard -> shard
worry -> worry
gland -> gland
health-care -> healthcare
embryo -> embryo
backup -> backup
titanium -> titanium
guest -> guest
comedy -> comedy
corn -> corn
eviction -> eviction
elite -> elite
organisation -> organisation
appropriation -> appropriation
maven -> maven
julia -> julia
exhaust -> exhaust
oath -> oath
mainframe -> mainframe
packing -> packing
retardant -> retardant
defence -> defence
separation -> separation
hypoglycemia -> hypoglycemia
juvenile -> juvenile
lewis -> lewis
dealer -> dealer
consomme -> consomme
hyperactivity -> hyperactivity
velcro -> velcro
method -> method
reclamation -> reclamation
colonel -> colonel
resistance -> resistance
celebration -> celebration
gallery -> gallery
angst -> angst
organizer -> organizer
bureau -> bureau
multiple -> multiple
cosmetic -> cosmetic
bypass -> bypass
holding -> holding
illiteracy -> illiteracy
thrift -> thrift
clearance -> clearance
intrusion -> intrusion
machinery -> machinery
light -> light
tent -> tent
player -> player
hatchet -> hatchet
peter -> peter
frog -> frog
operations -> operations
intervention -> intervention
tuck -> tuck
acceptance -> acceptance
educator -> educator
vision -> vision
works -> works
lien -> lien
spokesperson -> spokesperson
charge -> charge
touchdown -> touchdown
renovation -> renovation
exchange rate -> exchange#rate
allocation -> allocation
cut -> cut
mandate -> mandate
scheduling -> scheduling
carbohydrate -> carbohydrate
kelp -> kelp
air conditioning -> air_conditioning
decontrol -> decontrol
avocado -> avocado
forensics -> forensics
direction -> direction
weapons -> weapons
insect -> insect
giveaway -> giveaway
hole -> hole
haven -> haven
trashing -> trashing
psychiatrist -> psychiatrist
casino -> casino
machining -> machining
neglect -> neglect
header -> header
blood -> blood
circuit -> circuit
warhead -> warhead
rebate -> rebate
chair -> chair
patriot -> patriot
tweed -> tweed
interest rate -> interestrate
pap -> pap
manner -> manner
photograph -> photograph
woodland -> woodland
advisory -> advisory
lapse -> lapse
failing -> failing
lab -> lab
fox -> fox
sally -> sally
dove -> dove
usher -> usher
gravity -> gravity
arrest -> arrest
upstairs -> upstairs
father -> father
west -> west
wing -> wing
fact finding -> fact#finding
vow -> vow
trademark -> trademark
tradition -> tradition
church -> church
insurance -> insurance
fixed income -> fixed#income
pierre -> pierre
evaders -> evaders
summer -> summer
assemblyman -> assemblyman
currency -> currency
decibel -> decibel
pig -> pig
karaoke -> karaoke
dairy -> dairy
tampon -> tampon
instruction -> instruction
department -> department
graveside -> graveside
chateau -> chateau
kindergarten -> kindergarten
hunt -> hunt
fertility -> fertility
gorge -> gorge
system -> system
leg -> leg
transistor -> transistor
speaking -> speaking
cap -> cap
flip -> flip
exchange -> exchange
intake -> intake
squad -> squad
southwest -> southwest
col. -> col.
fernandez -> fernandez
dash -> dash
euro -> euro
good -> good
gauge -> gauge
shipper -> shipper
tumor -> tumor
catalog -> catalog
buchanan -> buchanan
three judge -> three#judge
parent -> parent
longitude -> longitude
finn -> finn
catfish -> catfish
id -> id
issue -> issue
distinction -> distinction
equipment -> equipment
science -> science
tyrant -> tyrant
treaty -> treaty
integrity -> integrity
boost -> boost
necklace -> necklace
incentive -> incentive
entrance -> entrance
lava -> lava
smash -> smash
suppressant -> suppressant
pundit -> pundit
tetanus -> tetanus
stopover -> stopover
sideline -> sideline
cottage -> cottage
resale -> resale
kilometers -> kilometers
davis -> davis
government -> government
refinancing -> refinancing
layoff -> layoff
dictatorship -> dictatorship
plea -> plea
homeowner -> homeowner
goalie -> goalie
bankruptcy -> bankruptcy
back -> back
author -> author
foreman -> foreman
restaurant -> restaurant
bash -> bash
salon -> salon
pastry -> pastry
number -> number
councilwoman -> councilwoman
ceremony -> ceremony
rod -> rod
juice -> juice
feta -> feta
fool -> fool
cutting -> cutting
tennis -> tennis
ice -> ice
abatement -> abatement
cotton -> cotton
crisis -> crisis
sanitation -> sanitation
success -> success
start -> start
birthing -> birthing
mainland -> mainland
carat -> carat
access -> access
line -> line
cowboy -> cowboy
ceasefire -> ceasefire
michael -> michael
propaganda -> propaganda
turf -> turf
agent -> agent
shooting -> shooting
methane -> methane
bundle -> bundle
rearguard -> rearguard
mathematics -> mathematics
sergeant -> sergeant
co-op -> co_op
regimen -> regimen
preseason -> preseason
cardboard -> cardboard
word -> word
seeker -> seeker
reelection -> reelection
ethnicity -> ethnicity
wastewater -> wastewater
sanders -> sanders
sweater -> sweater
drill -> drill
puncture -> puncture
stephanie -> stephanie
yard -> yard
beauty -> beauty
embassy -> embassy
whirlwind -> whirlwind
spree -> spree
bell -> bell
opponent -> opponent
cancellation -> cancellation
retailing -> retailing
picker -> picker
deprivation -> deprivation
chaser -> chaser
speculator -> speculator
boiler -> boiler
misconduct -> misconduct
collecting -> collecting
recital -> recital
favorite -> favorite
alleviation -> alleviation
graffiti -> graffiti
wedge -> wedge
wiring -> wiring
downgrade -> downgrade
rifle -> rifle
advice -> advice
oven -> oven
sailboat -> sailboat
sensitivity -> sensitivity
slaughter -> slaughter
professional -> professional
manpower -> manpower
nursing -> nursing
quota -> quota
spoof -> spoof
factoring -> factoring
upholstery -> upholstery
anthrax -> anthrax
diary -> diary
hormone -> hormone
salmon -> salmon
anniversary -> anniversary
slave -> slave
cocoa -> cocoa
midday -> midday
withdrawal -> withdrawal
suntan -> suntan
stopgap -> stopgap
gun -> gun
supercomputer -> supercomputer
look -> look
scrutiny -> scrutiny
selling -> selling
cider -> cider
roadside -> roadside
beating -> beating
inlay -> inlay
dr. -> dr.
four-wheel-drive -> four#wheel#drive
upside -> upside
private -> private
veto -> veto
tailpipe -> tailpipe
real estate -> real_estate
measure -> measure
platter -> platter
eye -> eye
contraband -> contraband
credentials -> credentials
prescription -> prescription
tar -> tar
incident -> incident
reign -> reign
guideline -> guideline
miracle -> miracle
equities -> equities
chalet -> chalet
shoes -> shoes
marsha -> marsha
suburb -> suburb
undergraduate -> undergraduate
sombrero -> sombrero
battle -> battle
homework -> homework
abuse -> abuse
remuneration -> remuneration
buzzword -> buzzword
motion -> motion
petition -> petition
height -> height
strategy -> strategy
tourism -> tourism
rationing -> rationing
tasting -> tasting
highway -> highway
harvesting -> harvesting
store -> store
steam -> steam
maker -> maker
monopoly -> monopoly
hippie -> hippie
electrician -> electrician
attendant -> attendant
dumping -> dumping
pile -> pile
chintz -> chintz
onion -> onion
jewel -> jewel
reunion -> reunion
ownership -> ownership
perk -> perk
regulator -> regulator
meningitis -> meningitis
boot -> boot
gasoline -> gasoline
subscriber -> subscriber
case -> case
reader -> reader
courtside -> courtside
difference -> difference
alert -> alert
johnson -> johnson
north -> north
peasant -> peasant
watching -> watching
biking -> biking
union -> union
safeguard -> safeguard
condolence -> condolence
fat -> fat
entry -> entry
tomorrow -> tomorrow
latitude -> latitude
circular -> circular
gown -> gown
interference -> interference
insult -> insult
plotter -> plotter
perception -> perception
privatization -> privatization
relations -> relations
negotiating -> negotiating
vegetation -> vegetation
routine -> routine
mortar -> mortar
diversity -> diversity
bar -> bar
slope -> slope
ivory -> ivory
workshop -> workshop
blanket -> blanket
gilbert -> gilbert
folks -> folks
menu -> menu
liberty -> liberty
tampering -> tampering
opener -> opener
basis -> basis
moratorium -> moratorium
decision -> decision
carrier -> carrier
interest -> interest
wear -> wear
swing -> swing
forfeiture -> forfeiture
chase -> chase
boy -> boy
globalization -> globalization
informer -> informer
softball -> softball
winston -> winston
multiyear -> multiyear
instinct -> instinct
heat -> heat
jean -> jean
affordability -> affordability
shield -> shield
piston -> piston
stock appreciation -> stock#appreciation
swim -> swim
argot -> argot
foe -> foe
fillet -> fillet
sting -> sting
habit -> habit
raiser -> raiser
assurance -> assurance
eel -> eel
console -> console
murder -> murder
faith -> faith
diving -> diving
oddity -> oddity
pawn -> pawn
whiz -> whiz
harlot -> harlot
southeast -> southeast
tackle -> tackle
parchment -> parchment
ken -> ken
interior -> interior
optimism -> optimism
pine -> pine
makeup -> makeup
homicide -> homicide
string -> string
side -> side
stalwart -> stalwart
emporium -> emporium
past -> past
turnout -> turnout
assistant -> assistant
tube -> tube
imperfection -> imperfection
unification -> unification
timber -> timber
scam -> scam
homecourt -> homecourt
maverick -> maverick
bong -> bong
arsenal -> arsenal
calling -> calling
ephedra -> ephedra
hat -> hat
roberts -> roberts
trial -> trial
hostage -> hostage
export -> export
trader -> trader
milling -> milling
analyst -> analyst
frame -> frame
firebomb -> firebomb
excise -> excise
county -> county
advertiser -> advertiser
commuter -> commuter
lawmaking -> lawmaking
poisoning -> poisoning
double -> double
junk-bond -> junk#bond
lee -> lee
gallows -> gallows
blend -> blend
menendez -> menendez
hepatitis -> hepatitis
grams -> grams
inhibitor -> inhibitor
burn -> burn
swap -> swap
inches -> inches
finale -> finale
surprise -> surprise
exporter -> exporter
motorway -> motorway
trucking -> trucking
practitioner -> practitioner
videocassette -> videocassette
disciplinary -> disciplinary
plot -> plot
relation -> relation
analysis -> analysis
century -> century
bulk -> bulk
reconciliation -> reconciliation
mine -> mine
plaid -> plaid
harvest -> harvest
commercial -> commercial
calibration -> calibration
statistic -> statistic
palace -> palace
salvage -> salvage
purchase -> purchase
cruise -> cruise
extinguisher -> extinguisher
donation -> donation
crawl -> crawl
death -> death
murderer -> murderer
insurer -> insurer
booking -> booking
procurator -> procurator
trouble -> trouble
cheer -> cheer
wakeup -> wakeup
tally -> tally
ration -> ration
shovel -> shovel
reel -> reel
drama -> drama
executive -> executive
plastic -> plastic
block -> block
rockefeller -> rockefeller
news -> news
seating -> seating
recruiting -> recruiting
particle -> particle
coach -> coach
unionist -> unionist
bathing -> bathing
rating -> rating
transport -> transport
byron -> byron
consolation -> consolation
protein -> protein
suspect -> suspect
competitor -> competitor
whitewater -> whitewater
grassroots -> grassroots
repertory -> repertory
axle -> axle
formation -> formation
coyote -> coyote
equality -> equality
ending -> ending
public address -> public#address
classified ad -> classified#ad
demon -> demon
treasure -> treasure
materials -> materials
featherweight -> featherweight
tuberculosis -> tuberculosis
manure -> manure
strap -> strap
institution -> institution
excavation -> excavation
gymnastics -> gymnastics
reliever -> reliever
fee -> fee
sushi -> sushi
manufacturer -> manufacturer
compensation -> compensation
emissions -> emissions
hometown -> hometown
revision -> revision
propulsion -> propulsion
recluse -> recluse
today -> today
smuggling -> smuggling
readiness -> readiness
bull -> bull
snapper -> snapper
laundering -> laundering
instrument -> instrument
syndrome -> syndrome
boycott -> boycott
visibility -> visibility
underwriting -> underwriting
lad -> lad
saver -> saver
smoking -> smoking
beet -> beet
aniline -> aniline
masking -> masking
comeback -> comeback
yearbook -> yearbook
impeachment -> impeachment
novelty -> novelty
billy -> billy
save -> save
semifinal -> semifinal
polyethylene -> polyethylene
sweepstake -> sweepstake
airforce -> airforce
commission -> commission
election -> election
citizenship -> citizenship
inventory -> inventory
radon -> radon
student -> student
outreach -> outreach
pesticide -> pesticide
vat -> vat
registration -> registration
province -> province
self -> self
lipid -> lipid
fist -> fist
vinyl -> vinyl
invoicing -> invoicing
bicycle -> bicycle
statehouse -> statehouse
idea -> idea
machinist -> machinist
killer -> killer
shorts -> shorts
construction -> construction
scale -> scale
disorder -> disorder
gunner -> gunner
club -> club
pact -> pact
solidarity -> solidarity
signing -> signing
gephardt -> gephardt
premium -> premium
theorist -> theorist
plantago -> plantago
petrochemical -> petrochemical
spokesman -> spokesman
appearance -> appearance
patent -> patent
cogeneration -> cogeneration
ghost -> ghost
rind -> rind
bombardment -> bombardment
grass -> grass
heart -> heart
expense -> expense
pit -> pit
clip -> clip
pitcher -> pitcher
barack -> barack
slaw -> slaw
parliament -> parliament
spike -> spike
secretary -> secretary
eating -> eating
record -> record
opera -> opera
listener -> listener
suffering -> suffering
martini -> martini
deukmejian -> deukmejian
insolvency -> insolvency
contest -> contest
tick -> tick
spirit -> spirit
motel -> motel
greenside -> greenside
folk -> folk
incinerator -> incinerator
offset -> offset
list -> list
thumbs-up -> thumbs#up
processor -> processor
office -> office
pharmacy -> pharmacy
involvement -> involvement
post -> post
sailor -> sailor
protector -> protector
surveillance -> surveillance
populist -> populist
gate -> gate
homer -> homer
bruise -> bruise
playoff -> playoff
infringement -> infringement
beach -> beach
egg industry -> egg#industry
sham -> sham
showroom -> showroom
tag -> tag
character -> character
grenade -> grenade
trip -> trip
cadre -> cadre
clarity -> clarity
objective -> objective
bottle -> bottle
repairman -> repairman
non-communist -> non#communist
chlorine -> chlorine
sweat -> sweat
rosenthal -> rosenthal
portal -> portal
skeleton -> skeleton
invalidity -> invalidity
samson -> samson
zhang -> zhang
referral -> referral
policeman -> policeman
cleaner -> cleaner
boxing -> boxing
farm -> farm
equivalent -> equivalent
inning -> inning
injury -> injury
parsing -> parsing
microbe -> microbe
pyramid -> pyramid
representative -> representative
grocery -> grocery
tablespoons -> tablespoons
hyena -> hyena
fundamentalist -> fundamentalist
vegetarian -> vegetarian
document -> document
commodities -> commodities
presence -> presence
name -> name
faithful -> faithful
underwear -> underwear
photo -> photo
george -> george
ground -> ground
furlough -> furlough
backing -> backing
strategist -> strategist
practices -> practices
hitter -> hitter
music -> music
couples -> couples
blumenthal -> blumenthal
tax -> tax
shift -> shift
headquarters -> headquarters
distress -> distress
overflow -> overflow
sprayer -> sprayer
manhole -> manhole
importer -> importer
flap -> flap
detention -> detention
demonstration -> demonstration
ineptness -> ineptness
perchlorate -> perchlorate
thought -> thought
douglas -> douglas
flying -> flying
amplifier -> amplifier
creditor -> creditor
ship -> ship
male -> male
contender -> contender
slogan -> slogan
livestock -> livestock
administration -> administration
shower -> shower
taxation -> taxation
hospice -> hospice
sumo -> sumo
prod -> prod
outpatient -> outpatient
owen -> owen
scan -> scan
forecasting -> forecasting
prince -> prince
disarmament -> disarmament
police -> police
guy -> guy
outplacement -> outplacement
fisher -> fisher
conditioning -> conditioning
testosterone -> testosterone
slam -> slam
foam -> foam
sanction -> sanction
seniority -> seniority
enhancement -> enhancement
stripper -> stripper
worthiness -> worthiness
proceeding -> proceeding
effect -> effect
licence -> licence
course correction -> course#correction
bully -> bully
expenditure -> expenditure
uncertainty -> uncertainty
spill -> spill
dweller -> dweller
tongue -> tongue
shrinkage -> shrinkage
hut -> hut
spray -> spray
orchestra -> orchestra
throes -> throes
enrollment -> enrollment
deficiency -> deficiency
delegation -> delegation
torturer -> torturer
jeep -> jeep
area -> area
bribery -> bribery
regulation -> regulation
generator -> generator
collection -> collection
queue -> queue
sedan -> sedan
counter -> counter
dope -> dope
raft -> raft
liquor -> liquor
gambling -> gambling
turmoil -> turmoil
carpet -> carpet
megabyte -> megabyte
cataract -> cataract
housing -> housing
closing -> closing
ian -> ian
discipline -> discipline
scouting -> scouting
shrapnel -> shrapnel
massacre -> massacre
cement -> cement
soybean -> soybean
howard -> howard
diplomat -> diplomat
ammonium -> ammonium
group -> group
meaning -> meaning
alliance -> alliance
footwear -> footwear
adjuster -> adjuster
climate -> climate
cycling -> cycling
frederick -> frederick
cable tv -> cable#tv
write-in -> write#in
pillar -> pillar
inoculation -> inoculation
fabrication -> fabrication
site -> site
coon -> coon
feeding -> feeding
pornography -> pornography
endgame -> endgame
boyle -> boyle
treatment -> treatment
questioning -> questioning
input -> input
seven-nation -> seven#nation
sellout -> sellout
respondent -> respondent
crow -> crow
storage -> storage
precaution -> precaution
rat -> rat
quarterfinal -> quarterfinal
help -> help
gaming -> gaming
grant -> grant
defense -> defense
tenure -> tenure
bridge -> bridge
mid-afternoon -> mid#afternoon
representation -> representation
version -> version
mediator -> mediator
formulation -> formulation
expulsion -> expulsion
quail -> quail
cockpit -> cockpit
measuring -> measuring
studio -> studio
motif -> motif
old -> old
ryan -> ryan
audio -> audio
manufacture -> manufacture
insulin -> insulin
publishing -> publishing
cod liver -> cod_liver
display -> display
endowment -> endowment
automobile -> automobile
nose -> nose
adrenaline -> adrenaline
vegan -> vegan
decay -> decay
ton -> ton
embezzlement -> embezzlement
producer -> producer
rouble -> rouble
maize -> maize
corner -> corner
sheep -> sheep
tribunal -> tribunal
ratings -> ratings
middleman -> middleman
pad -> pad
blocker -> blocker
two income -> two#income
virus -> virus
chatter -> chatter
boring -> boring
tusk -> tusk
convoy -> convoy
mail -> mail
restraint -> restraint
information -> information
capt. -> capt.
grill -> grill
root -> root
faculty -> faculty
assignment -> assignment
pocket -> pocket
ethylene -> ethylene
acne -> acne
jar -> jar
trafficking -> trafficking
clothes -> clothes
highschool -> highschool
catastrophe -> catastrophe
childcare -> childcare
streak -> streak
trap -> trap
cutter -> cutter
friendliness -> friendliness
indicator -> indicator
licensing -> licensing
slide -> slide
world class -> world#class
cab -> cab
drop-off -> drop#off
pumpkin -> pumpkin
starter -> starter
liberalisation -> liberalisation
strip -> strip
television -> television
navy -> navy
stain -> stain
green -> green
route -> route
topaz -> topaz
priest -> priest
judge -> judge
marshal -> marshal
sighting -> sighting
factory -> factory
stalling -> stalling
lineman -> lineman
exhibit -> exhibit
blower -> blower
edge -> edge
picnic -> picnic
willow -> willow
maintenance -> maintenance
pigeon -> pigeon
fitzpatrick -> fitzpatrick
eucalyptus -> eucalyptus
lesson -> lesson
jury -> jury
cattle -> cattle
language -> language
gathering -> gathering
bone -> bone
traversal -> traversal
rebellion -> rebellion
urine -> urine
whizz -> whizz
money-laundering -> money_laundering
aluminum -> aluminum
cyclist -> cyclist
auto -> auto
activist -> activist
keith -> keith
warship -> warship
quarter -> quarter
appropriations -> appropriations
conflict-of-interest -> conflict#of#interest
slalom -> slalom
truce -> truce
enthusiast -> enthusiast
smith -> smith
uranium -> uranium
vanilla -> vanilla
paramilitary -> paramilitary
horse -> horse
health -> health
literature -> literature
shampoo -> shampoo
withholding -> withholding
helicopter -> helicopter
autonomy -> autonomy
stop-loss -> stop#loss
banking -> banking
electron -> electron
mentality -> mentality
mind -> mind
substation -> substation
injection -> injection
subway -> subway
buff -> buff
dancing -> dancing
history -> history
weather -> weather
capital gains -> capital#gains
camp -> camp
exam -> exam
furniture -> furniture
spurt -> spurt
sgt. -> sgt.
investment -> investment
condemnation -> condemnation
armory -> armory
aficionado -> aficionado
pool -> pool
fitzwater -> fitzwater
picking -> picking
exhaustion -> exhaustion
deliberation -> deliberation
anchor -> anchor
road -> road
game -> game
initiative -> initiative
bonds -> bonds
alligator -> alligator
newsletter -> newsletter
bullion -> bullion
cook -> cook
photography -> photography
conflict of interest -> conflict#of#interest
sperm -> sperm
need -> need
pain -> pain
win -> win
empowerment -> empowerment
capability -> capability
volt -> volt
max -> max
feud -> feud
intellectual -> intellectual
quotation -> quotation
flaw -> flaw
wealth -> wealth
man -> man
salad -> salad
integration -> integration
fish -> fish
victim -> victim
musical -> musical
pacemaker -> pacemaker
report -> report
critic -> critic
home improvement -> home#improvement
ornament -> ornament
implant -> implant
refugee -> refugee
exhibition -> exhibition
bag -> bag
ear -> ear
flowing -> flowing
setup -> setup
piece -> piece
hero -> hero
disruption -> disruption
span -> span
smoke -> smoke
book -> book
crush -> crush
schneider -> schneider
sport -> sport
lemon -> lemon
charm -> charm
monitoring -> monitoring
incision -> incision
foundation -> foundation
midway -> midway
investigator -> investigator
rightfield -> rightfield
devaluation -> devaluation
artillerist -> artillerist
electronics -> electronics
skirmish -> skirmish
raid -> raid
hoard -> hoard
platform -> platform
homeland -> homeland
financing -> financing
medicine -> medicine
coca -> coca
dial -> dial
boss -> boss
john -> john
datum -> datum
bonus -> bonus
recommendation -> recommendation
refinery -> refinery
after-hours -> after#hours
brown -> brown
discrepancy -> discrepancy
halogen -> halogen
personality -> personality
infantry -> infantry
afternoon -> afternoon
banquet hall -> banquet_hall
maximum -> maximum
glasses -> glasses
ballot -> ballot
professor -> professor
silo -> silo
basket -> basket
canister -> canister
box office -> box#office
combustion -> combustion
discrimination -> discrimination
cork -> cork
closure -> closure
train -> train
gardener -> gardener
society -> society
constituency -> constituency
bleach -> bleach
elimination -> elimination
flour -> flour
censure -> censure
trading -> trading
disc -> disc
hiring -> hiring
bidder -> bidder
movement -> movement
liquidity -> liquidity
dual-trading -> dual#trading
burden -> burden
joe -> joe
warrant -> warrant
lobbyist -> lobbyist
target -> target
conduit -> conduit
holmes -> holmes
art -> art
test -> test
safety -> safety
originator -> originator
mode -> mode
arson -> arson
blood clot -> blood_clot
sector -> sector
habitat -> habitat
trouser -> trouser
expert -> expert
tremor -> tremor
flier -> flier
internship -> internship
sanctions -> sanctions
powerhouse -> powerhouse
statute -> statute
competency -> competency
sect -> sect
imitation -> imitation
chandelier -> chandelier
lime -> lime
racketeering -> racketeering
lede -> lede
shadow -> shadow
mr. -> mr.
ladder -> ladder
rally -> rally
comfort -> comfort
courthouse -> courthouse
soccer -> soccer
college sports -> college#sports
citizen -> citizen
visitor -> visitor
full-year -> full#year
arrival -> arrival
harness -> harness
james -> james
wartime -> wartime
blow -> blow
cardigan -> cardigan
applicant -> applicant
dancer -> dancer
conservationist -> conservationist
productivity -> productivity
deja -> deja
lesbian -> lesbian
appreciation -> appreciation
stock -> stock
blizzard -> blizzard
obsessive -> obsessive
desalinization -> desalinization
outflow -> outflow
loyalty -> loyalty
surplus -> surplus
medley -> medley
rheumatism -> rheumatism
wonk -> wonk
break -> break
atheist -> atheist
budget -> budget
bracelet -> bracelet
ferry -> ferry
tapestry -> tapestry
watcher -> watcher
curve -> curve
pass -> pass
treasury -> treasury
dashboard -> dashboard
possession -> possession
walkout -> walkout
data -> data
tie -> tie
rollback -> rollback
kirk -> kirk
yacht -> yacht
escape -> escape
major -> major
waiting -> waiting
hiatus -> hiatus
billboard -> billboard
moisture -> moisture
diversification -> diversification
pharmaceutical -> pharmaceutical
storm -> storm
terrorist -> terrorist
mangrove -> mangrove
censor -> censor
patient -> patient
toxin -> toxin
funeral -> funeral
debris -> debris
tsunami -> tsunami
transformation -> transformation
depot -> depot
deployment -> deployment
technology -> technology
trout -> trout
detail -> detail
chewing -> chewing
occupancy -> occupancy
clubhouse -> clubhouse
teller -> teller
credit -> credit
hack -> hack
neck -> neck
claim -> claim
goods -> goods
sauce -> sauce
self-rule -> self#rule
following -> following
ribbon -> ribbon
canning -> canning
tavern -> tavern
options -> options
sinking fund -> sinking#fund
dialogue -> dialogue
ruble -> ruble
vlad -> vlad
segregation -> segregation
strain -> strain
rabbi -> rabbi
soul -> soul
sculpture -> sculpture
gooseberry -> gooseberry
prediction -> prediction
jeremy -> jeremy
statistics -> statistics
girl -> girl
material -> material
depreciation -> depreciation
doughnut -> doughnut
hair -> hair
power -> power
lifetime -> lifetime
passenger -> passenger
flash -> flash
egg -> egg
dedication -> dedication
thief -> thief
atom -> atom
marrow -> marrow
therapist -> therapist
puree -> puree
helium -> helium
divinity -> divinity
proceeds -> proceeds
thompson -> thompson
homecoming -> homecoming
perjury -> perjury
liquid -> liquid
confusion -> confusion
watchdog -> watchdog
tightrope -> tightrope
christie -> christie
clout -> clout
spending -> spending
poll -> poll
nightclub -> nightclub
patrol -> patrol
pane -> pane
progress -> progress
folklore -> folklore
harvester -> harvester
merchandise -> merchandise
angioplasty -> angioplasty
sitter -> sitter
pressure -> pressure
carbon dioxide -> carbon_dioxide
result -> result
canvassing -> canvassing
briefing -> briefing
royalty -> royalty
region -> region
editing -> editing
beep -> beep
talk -> talk
rainfall -> rainfall
day -> day
laborer -> laborer
struggle -> struggle
levy -> levy
merchandiser -> merchandiser
screw -> screw
deserter -> deserter
peach -> peach
stat -> stat
earner -> earner
wheat -> wheat
face -> face
wrist -> wrist
maternity -> maternity
listing -> listing
square -> square
pest -> pest
sticker -> sticker
cake -> cake
camera -> camera
servicing -> servicing
visit -> visit
inmate -> inmate
due process -> due#process
garden -> garden
crescent -> crescent
bloc -> bloc
gift -> gift
sociology -> sociology
ingestion -> ingestion
dorothy -> dorothy
model -> model
military -> military
austerity -> austerity
formula -> formula
politics -> politics
water -> water
backlog -> backlog
compound -> compound
counseling -> counseling
alcohol -> alcohol
poetry -> poetry
promoter -> promoter
shortage -> shortage
sale -> sale
fingerprint -> fingerprint
goal -> goal
summit -> summit
smokestack -> smokestack
gear -> gear
layup -> layup
torch -> torch
crony -> crony
raspberry -> raspberry
grade -> grade
rap -> rap
vegetable -> vegetable
severance -> severance
warehouse -> warehouse
nominating -> nominating
trampoline -> trampoline
ozone -> ozone
subpoena -> subpoena
scratch -> scratch
armament -> armament
minitruck -> minitruck
load -> load
racehorse -> racehorse
knowledge -> knowledge
substitution -> substitution
radio -> radio
maureen -> maureen
masseuse -> masseuse
death sentence -> death#sentence
shapiro -> shapiro
brewing -> brewing
narcotic -> narcotic
clipping -> clipping
copying -> copying
sarah -> sarah
degradation -> degradation
pudding -> pudding
submarine -> submarine
setting -> setting
meeting -> meeting
drinker -> drinker
loner -> loner
inquiry -> inquiry
table -> table
con -> con
snap -> snap
kagen -> kagen
trainer -> trainer
resolution -> resolution
hooligan -> hooligan
suicide -> suicide
approach -> approach
musician -> musician
stay -> stay
voter -> voter
burning -> burning
magnet -> magnet
junction -> junction
woe -> woe
crude -> crude
armor -> armor
physician -> physician
playing -> playing
course -> course
buyer -> buyer
song -> song
egghead -> egghead
controller -> controller
admiration -> admiration
sweatshirt -> sweatshirt
tabulation -> tabulation
martinez -> martinez
examination -> examination
scar -> scar
battlegroups -> battlegroups
dryer -> dryer
gershwin -> gershwin
durables -> durables
jewelry -> jewelry
alan -> alan
pasture -> pasture
booth -> booth
schoolgirl -> schoolgirl
plant -> plant
coming-out -> coming#out
pineapple -> pineapple
discussion -> discussion
jogging -> jogging
nonaggression -> nonaggression
drawer -> drawer
refrigerator -> refrigerator
freedom -> freedom
ambassador -> ambassador
signal -> signal
quart -> quart
mother -> mother
seed -> seed
purpose -> purpose
hauler -> hauler
clothing -> clothing
basketball -> basketball
sum -> sum
structure -> structure
market system -> market#system
procurement -> procurement
communication -> communication
chocolate -> chocolate
lawsuit -> lawsuit
putt -> putt
quote -> quote
failure -> failure
solicitor -> solicitor
parity -> parity
resignation -> resignation
smear -> smear
liberal -> liberal
gain -> gain
fetus -> fetus
boutique -> boutique
marks -> marks
gyration -> gyration
junk -> junk
poem -> poem
source -> source
poison -> poison
mineral -> mineral
pound -> pound
appeal -> appeal
cleaning -> cleaning
ability -> ability
sentencing -> sentencing
brewery -> brewery
upset -> upset
complaint -> complaint
revival -> revival
cassette -> cassette
divider -> divider
tomaski -> tomaski
image -> image
zuckerman -> zuckerman
sky -> sky
rate -> rate
attire -> attire
stronghold -> stronghold
recruitment -> recruitment
newsprint -> newsprint
neighbor -> neighbor
asthma -> asthma
unemployment -> unemployment
concentration -> concentration
resort -> resort
cafe -> cafe
attribute -> attribute
chef -> chef
impediment -> impediment
preadmission -> preadmission
jam -> jam
developing -> developing
clutter -> clutter
sensing -> sensing
director -> director
allergy -> allergy
goldfish -> goldfish
silicone -> silicone
aluminium -> aluminium
swearing-in -> swearing#in
attack -> attack
daycare -> daycare
civilian -> civilian
zone -> zone
company -> company
protester -> protester
acre -> acre
operator -> operator
east -> east
lake -> lake
lounge -> lounge
email -> email
combat -> combat
leprosy -> leprosy
technique -> technique
funding -> funding
wheelchair -> wheelchair
banker -> banker
favorability -> favorability
nonproliferation -> nonproliferation
monk -> monk
shortfall -> shortfall
coffer -> coffer
hike -> hike
wash -> wash
witness -> witness
trooper -> trooper
chapel -> chapel
village -> village
biotechnology -> biotechnology
multihomer -> multihomer
revenge -> revenge
relay -> relay
sovereignty -> sovereignty
free market -> free#market
spasm -> spasm
dismantlement -> dismantlement
cordon -> cordon
logo -> logo
marathon -> marathon
cruiser -> cruiser
villager -> villager
cease-fire -> ceasefire
footage -> footage
william -> william
weevil -> weevil
coverage -> coverage
repatriation -> repatriation
informant -> informant
hood -> hood
pancake -> pancake
tea -> tea
rollover -> rollover
convention -> convention
layout -> layout
opposition -> opposition
monitor -> monitor
meter -> meter
transfusion -> transfusion
concerto -> concerto
walk -> walk
commando -> commando
incumbency -> incumbency
widget -> widget
mortality -> mortality
trendsetter -> trendsetter
welterweight -> welterweight
one-off -> one#off
complicity -> complicity
fanatic -> fanatic
wine -> wine
apprenticeship -> apprenticeship
literacy -> literacy
heir -> heir
houseboat -> houseboat
tie-up -> tie#up
question -> question
probate -> probate
copper -> copper
sign -> sign
costume -> costume
coat -> coat
opium -> opium
hobbyist -> hobbyist
rusher -> rusher
kernel -> kernel
subtilis -> subtilis
debit -> debit
well -> well
school -> school
rejection -> rejection
equity -> equity
elephant -> elephant
ammunition -> ammunition
gardening -> gardening
brother -> brother
common -> common
rumour -> rumour
cupboard -> cupboard
correspondence -> correspondence
specialty -> specialty
clause -> clause
affiliation -> affiliation
landfill -> landfill
hydropower -> hydropower
offensive -> offensive
deposition -> deposition
tyson -> tyson
reality -> reality
blue -> blue
restoration -> restoration
existence -> existence
concession -> concession
aviation -> aviation
child -> child
cure -> cure
interdiction -> interdiction
overhaul -> overhaul
gallium -> gallium
pattern -> pattern
mariachi -> mariachi
participation -> participation
shot -> shot
net -> net
violence -> violence
stereo -> stereo
foreigner -> foreigner
litter -> litter
arsenic -> arsenic
date -> date
voyage -> voyage
family -> family
can -> can
flower -> flower
decoration -> decoration
fund -> fund
conservancy -> conservancy
bean -> bean
clay -> clay
medalist -> medalist
shoe -> shoe
foreign exchange -> foreign#exchange
stationery -> stationery
pullout -> pullout
pie -> pie
secretin -> secretin
priority -> priority
collapse -> collapse
miss -> miss
charles -> charles
viewing -> viewing
traffic -> traffic
security -> security
voice -> voice
soil -> soil
retraining -> retraining
brutality -> brutality
loser -> loser
buying -> buying
plasterboard -> plasterboard
overtime -> overtime
grease -> grease
commodity -> commodity
clock -> clock
woman -> woman
litmus -> litmus
automation -> automation
to-do -> to#do
boating -> boating
viewer -> viewer
richardson -> richardson
committee -> committee
ulcer -> ulcer
diver -> diver
lucy -> lucy
scholarship -> scholarship
deferral -> deferral
inauguration -> inauguration
underdog -> underdog
rush -> rush
moon -> moon
allegation -> allegation
custody -> custody
zoning -> zoning
crosstown -> crosstown
human -> human
growing -> growing
marijuana -> marijuana
invasion -> invasion
earth -> earth
alarm -> alarm
butterfly -> butterfly
sister -> sister
laundry -> laundry
extinction -> extinction
capitalization -> capitalization
scavenger -> scavenger
commentator -> commentator
elbow -> elbow
wool -> wool
turtle -> turtle
cartoon -> cartoon
rains -> rains
advance -> advance
file -> file
human rights -> human_rights
pen -> pen
initiation -> initiation
deregulation -> deregulation
fertilizer -> fertilizer
homeless -> homeless
missionary -> missionary
telemarketing -> telemarketing
driver -> driver
slum -> slum
abortion -> abortion
blueprint -> blueprint
monetarist -> monetarist
phytoplankton -> phytoplankton
call -> call
ad -> ad
mesh -> mesh
crackdown -> crackdown
trail -> trail
projects -> projects
cole -> cole
accident -> accident
limb -> limb
recycling -> recycling
garlic -> garlic
pantry -> pantry
malnutrition -> malnutrition
text -> text
accommodation -> accommodation
officer -> officer
billing -> billing
segment -> segment
apple -> apple
authorities -> authorities
yesterday -> yesterday
item -> item
truman -> truman
inefficiency -> inefficiency
worship -> worship
covering -> covering
supermarket -> supermarket
job -> job
salary -> salary
lamb -> lamb
slowdown -> slowdown
fast food -> fast#food
desecration -> desecration
patronage -> patronage
wording -> wording
methyl -> methyl
potential -> potential
refiner -> refiner
compliance -> compliance
biker -> biker
impact -> impact
seafood -> seafood
learning -> learning
lettuce -> lettuce
wafer -> wafer
capsule -> capsule
ceramics -> ceramics
curator -> curator
utility -> utility
branch -> branch
slot -> slot
show -> show
customer -> customer
screen -> screen
auditor -> auditor
roundtable -> roundtable
revisionist -> revisionist
funds -> funds
messinger -> messinger
molestation -> molestation
shutoff -> shutoff
gorbachev -> gorbachev
feed -> feed
cooperation -> cooperation
ordeal -> ordeal
establishment -> establishment
northwest -> northwest
toilet -> toilet
rite -> rite
assembly line -> assembly#line
watermelon -> watermelon
kid -> kid
review -> review
ballast -> ballast
tinfoil -> tinfoil
supporter -> supporter
supply -> supply
wonderland -> wonderland
joker -> joker
coroner -> coroner
hype -> hype
pencil -> pencil
exploration -> exploration
farm machine -> farm#machine
reconfirmation -> reconfirmation
trawler -> trawler
venture -> venture
gall -> gall
tim -> tim
malfunction -> malfunction
stylist -> stylist
consent -> consent
cape -> cape
receipt -> receipt
controversy -> controversy
backstroke -> backstroke
defiance -> defiance
ignorance -> ignorance
silicon -> silicon
principal -> principal
watercolor -> watercolor
resource -> resource
scorer -> scorer
arsenide -> arsenide
bug -> bug
custom -> custom
series -> series
handbag -> handbag
rig -> rig
fusion -> fusion
valley -> valley
digit -> digit
participant -> participant
rutherford -> rutherford
parlor -> parlor
hearing -> hearing
self-help -> self#help
sweetheart -> sweetheart
migrant -> migrant
product -> product
capri -> capri
signatory -> signatory
auction -> auction
bellwether -> bellwether
territory -> territory
inflow -> inflow
noon -> noon
airline -> airline
plate -> plate
candlelight -> candlelight
implementation -> implementation
tortilla -> tortilla
barkowitz -> barkowitz
estate -> estate
fastener -> fastener
weightlifting -> weightlifting
tech -> tech
jetliner -> jetliner
earnings -> earnings
energy -> energy
shape -> shape
extension -> extension
absence -> absence
videotape -> videotape
lover -> lover
battlefield -> battlefield
balloon -> balloon
credential -> credential
abuser -> abuser
perimeter -> perimeter
destroyer -> destroyer
uniform -> uniform
disco -> disco
supervision -> supervision
randall -> randall
caviar -> caviar
o'brien -> o'brien
awareness -> awareness
jitter -> jitter
pamela -> pamela
betterment -> betterment
rights -> rights
waste -> waste
heinz -> heinz
flag -> flag
spider -> spider
jaunt -> jaunt
pulp -> pulp
piracy -> piracy
adoption -> adoption
hurricane -> hurricane
parole -> parole
shelling -> shelling
shutout -> shutout
faction -> faction
bran -> bran
employment -> employment
inbounds -> inbounds
twig -> twig
athletics -> athletics
grab -> grab
stem -> stem
two-thirds -> two#thirds
leader -> leader
wall -> wall
gigabyte -> gigabyte
scout -> scout
agriculture -> agriculture
microprocessor -> microprocessor
cramp -> cramp
caller -> caller
license -> license
cultivation -> cultivation
plane -> plane
deflection -> deflection
halftime -> halftime
place -> place
insert -> insert
location -> location
closeup -> closeup
demand -> demand
rudolph -> rudolph
harmony -> harmony
ceiling -> ceiling
paradigm -> paradigm
street -> street
sufferer -> sufferer
minority -> minority
pres. -> pres.
marketer -> marketer
jaime -> jaime
pep -> pep
dealing -> dealing
launderer -> launderer
detector -> detector
pistol -> pistol
collar -> collar
diehard -> diehard
autograph -> autograph
coupon -> coupon
frigate -> frigate
gov. -> gov.
secessionist -> secessionist
palm tree -> palm_tree
advertisement -> advertisement
installation -> installation
lisa -> lisa
address -> address
centre -> centre
bragging -> bragging
skunk -> skunk
sidewalk -> sidewalk
rental -> rental
beef -> beef
roof -> roof
classroom -> classroom
confirmation -> confirmation
film -> film
imbalance -> imbalance
strainer -> strainer
disintegration -> disintegration
handling -> handling
cedar -> cedar
motorcycle -> motorcycle
neighborhood -> neighborhood
shelf -> shelf
knicker -> knicker
rock -> rock
eisenhower -> eisenhower
nitya -> nitya
tonne -> tonne
dose -> dose
guerrilla -> guerrilla
hotel -> hotel
aircraft -> aircraft
fetishist -> fetishist
sherbet -> sherbet
retirement -> retirement
attendee -> attendee
mortuary -> mortuary
community -> community
length -> length
peppermint -> peppermint
curriculum -> curriculum
foreclosure -> foreclosure
brick -> brick
testing -> testing
sanctuary -> sanctuary
level -> level
sell -> sell
disclosure -> disclosure
tract -> tract
bookstore -> bookstore
effort -> effort
mall -> mall
commerce -> commerce
theft -> theft
cushioning -> cushioning
authority -> authority
explosive -> explosive
bishop -> bishop
recession -> recession
spotlight -> spotlight
forgiveness -> forgiveness
granite -> granite
caravan -> caravan
partnership -> partnership
box -> box
brand -> brand
historian -> historian
expansion -> expansion
victory -> victory
preserve -> preserve
ancestor -> ancestor
cutoff -> cutoff
reagan era -> reagan#era
repayment -> repayment
oak -> oak
staff reduction -> staff#reduction
roster -> roster
mcjames -> mcjames
album -> album
investing -> investing
inhabitant -> inhabitant
steak -> steak
recorder -> recorder
tutorial -> tutorial
trek -> trek
medal -> medal
diversion -> diversion
booklet -> booklet
cell -> cell
warming -> warming
slash -> slash
photographer -> photographer
excretion -> excretion
boa -> boa
coconut -> coconut
bus -> bus
runner -> runner
heartbreak -> heartbreak
math -> math
turboprop -> turboprop
loophole -> loophole
normalization -> normalization
middle class -> middle#class
cult -> cult
superconductor -> superconductor
multiparty -> multiparty
pro -> pro
windfall -> windfall
carver -> carver
conglomerate -> conglomerate
bullhorn -> bullhorn
fauna -> fauna
shipyard -> shipyard
thinner -> thinner
religion -> religion
urethane -> urethane
fanny -> fanny
agenda -> agenda
alloy -> alloy
channel -> channel
headline -> headline
cutout -> cutout
switching -> switching
platoon -> platoon
eyewitness -> eyewitness
elder -> elder
world -> world
athlete -> athlete
criminal -> criminal
leadoff -> leadoff
drape -> drape
fledgling -> fledgling
watchman -> watchman
isaac -> isaac
jute -> jute
sugar -> sugar
jacobson -> jacobson
outbreak -> outbreak
price -> price
mountain bike -> mountain_bike
delivery -> delivery
affair -> affair
kick -> kick
programmer -> programmer
throwing -> throwing
rep. -> rep.
depletion -> depletion
hussein -> hussein
operation -> operation
launching -> launching
sharing -> sharing
zip -> zip
foray -> foray
clown -> clown
dummy -> dummy
compost -> compost
corrosion -> corrosion
war -> war
tape -> tape
journalism -> journalism
stimulation -> stimulation
schoenberg -> schoenberg
placebo -> placebo
performance -> performance
waitress -> waitress
bamboo -> bamboo
divorce -> divorce
pledge -> pledge
patron -> patron
influence -> influence
final -> final
harbor -> harbor
steering -> steering
instructor -> instructor
repeater -> repeater
wave -> wave
daughter -> daughter
recovery -> recovery
moderate -> moderate
therapy -> therapy
fever -> fever
sack -> sack
trunk -> trunk
tourist -> tourist
residence -> residence
gimmickry -> gimmickry
facsimile -> facsimile
riverboat -> riverboat
torture -> torture
handkerchief -> handkerchief
rye -> rye
engagement -> engagement
consultant -> consultant
commentary -> commentary
locomotive -> locomotive
affairs -> affairs
resettlement -> resettlement
endangerment -> endangerment
semiconductor -> semiconductor
pageant -> pageant
usage -> usage
trench -> trench
broadcaster -> broadcaster
lap -> lap
worm -> worm
graphic -> graphic
technician -> technician
chief -> chief
fire -> fire
subcommittee -> subcommittee
travelers -> travelers
venom -> venom
champion -> champion
badminton -> badminton
team -> team
noodle -> noodle
home -> home
devastation -> devastation
bill -> bill
spectator -> spectator
country -> country
seminary -> seminary
kaufman -> kaufman
commonwealth -> commonwealth
bonnie -> bonnie
printing -> printing
head -> head
twist -> twist
crane -> crane
glitch -> glitch
bolt -> bolt
aerobics -> aerobics
publication -> publication
sonar -> sonar
labour -> labour
badge -> badge
cicada -> cicada
reinvigoration -> reinvigoration
sleeve -> sleeve
spirits -> spirits
protectionist -> protectionist
reduction -> reduction
component -> component
smoker -> smoker
x-ray -> x_ray
facing -> facing
baggage -> baggage
sampling -> sampling
weakness -> weakness
encoding -> encoding
